boss lady boom	AHKru
alizalicht super awkward gait	AHKru
vmochama love tetanus shot morning coffee wakes highly recommended	AHKru
stacylondon thought bear revenant hibernation woke	AHKru
jacob tremblay corrected giuliana mispronunciation film room room goldenglobes	AHKru
driving city shout man prancing condo light sabre force bro toronto starwars	AHKru
thing oral health obsession conversation wur bff cross pathsthink reach molars better floss ppl	AHKru
nous sommes toutes fran ais ce soir paris	AHKru
eddykayla chance obsessed frozen	AHKru
wow shopify news lighting kw today	AHKru
well canadians wait retire snowbirds caymens calling	AHKru
shout summer stayalittlelonger	AHKru
grtrow pm pm pm fairview park	AHKru
happy birthday merciersara	AHKru
antman st movie paulrudd sound pasties mouth ya earned glass water rudd goodgo watch	AHKru
yup starbucks friday	AHKru
happy thofjuly americagrowing bordertown luxury celebrating canada day weektoo fun	AHKru
wait months weeks hour gameofthrones hurt good gameofthrones hurt good hbo	AHKru
gal wearing head toe pvc hope uve invested baby powder time gluing urself outfit	AHKru
jbkruschack loveem missem	AHKru
going vegas going dufferin lolz toronto ttc drunk talk bus ossington	AHKru
mpcpublic bbmattk going to eat time kw friendly heads	AHKru
counter top matches schiuma ooh la la coffee	AHKru
to walk lighting kit surrounding times	AHKru
cool round bike easy cycling head steaming nice	AHKru
kind smartphone cc bbmattk	AHKru
bike bad start week cyling fitness	AHKru
experience isleofskye wow dannymacaskill jaw dropping stunning scotland	AHKru
eddykayla hahahahahahha xo	AHKru
wow true fit feature nordstrom level online shopping ahead money earned	AHKru
che brava calabrisella braciole mangiare stasera italian goodeats summer	AHKru
hot hot hot bag time celebrate canadaday lake superior good cancuk canadiansdoitbetter	AHKru
eddykayla meghanrocca fun xo	AHKru
cnet zoku iced coffee maker dilution alizalicht iced coffee game changer	AHKru
finished solid habs won cest bon gohabsgo beauty goodnight folks	AHKru
iphone dies developer wings	AHKru
buddy everyday cruising wanted pocket	AHKru
wowbig canadian girl nivathabalendra girl fire makerswomen check girl proudcanuck	AHKru
love fashionistacom siteso fresh cleanesp love blackberry image wthe fabulous red mani biz	AHKru
great kickoff month received daily theskimm today ladies	AHKru
speak devil appear banecat	AHKru
merciersara love case sara	AHKru
ninja emoticon bbm describe scandalous creativity level hit high	AHKru
people gold medal hockey sticks garden tomatoes summer luckyloonie	AHKru
game checkers benn canada lotta hockey play gocanadago	AHKru
game sooboys gold teambradjacobs	AHKru
bad veneers sheeesh bite face	AHKru
extra special opening ceremonies teambradjacobs representing thesoo canada good luck boys	AHKru
pepsi sb color coordinating concert mountain dew theme	AHKru
feel taylor swift best blonde kate middleton impression tonight thegrammys meh aint princess	AHKru
nordstrom coming eatoncentre good news tuesday	AHKru
statscanada canadians feel alive slipping sidewalk reminds canadians catlike reflexes	AHKru
matthew mcconaughey killed dolcegabbana green leather lapel gentlemen goldenglobes	AHKru
coachkhamilton gross feel pain forget wind chill ham anddd today edinburgh	AHKru
wow software updates morning coffee biscotti	AHKru
moment confident italian language skills friend people crowdsmybad	AHKru
edxmas light night today excited edinburghlove	AHKru
turns vintage leather gloves friendly txting gloves babies buttery soft works finemonday win	AHKru
serdatweets limited chambray shirtjeans jean jacket felt gooddidnt canadiantire gbp starbucks	AHKru
qualcomm snapdragon processor spot youtube brilliant dragon mine blackberry	AHKru
alizalicht cape win	AHKru
dkny user babiesbackup batterydoubleusb chargerthis ladybeasts ready	AHKru
eddykayla discovers free global wifi calling bbm priceless troubleshooting phone atlantic	AHKru
write find listening thetingtings queen beyonce guess	AHKru
continue day success	AHKru
living nyfw dkny tweetswish nyc experiencing beast aka nyfwi suspect fastest thumbs	AHKru
reply retweet ugh	AHKru
happy canada day week border town celebrations continue proudcanadian	AHKru
bbmattk steelton bike lanes ride die	AHKru
outright check coverage maps save article techvibes help decide	AHKru
dear updated planner android displease great deal wednesday morning thumbs	AHKru
vmochama enjoyed spot friend spot homework people er hippos	AHKru
mediaobsessed dce lays hammer	AHKru
mediaobsessed incorrect prods market wquad core best keyboard security best bizpersonal ready os	AHKru
soooooooo ers showing	AHKru
boom internet doprah wonder james fryed lance armstrong lied face	AHKru
hardware cut paste best love raised cells phone acid	AHKru
avid ebay user kudos ebay	AHKru
woke tinge disappointment case mondays thought today cybermonday boo	AHKru
couple matching camouflage hats walking hand hand sooberia disturbing	AHKru
elusivebalance heard mmm eat list lol	AHKru
missing redbullstratos livejump	AHKru
wait baby thor kruschack kw contingent evening xoxoxo	AHKru
happy oktoberfest munich courtesy buzzfeed	AHKru
maggieyepes thought worth attention lol	AHKru
chilly night north enjoying cruising skies wmy whatsup app playbook	AHKru
aliceluong going respond ditto	AHKru
aliceluong inner desire buy pens quit	AHKru
trip bon temps tomorrow night sad	AHKru
song dedicated lance armstrong fans juicy notorious big ya ya	AHKru
hrs labor msging wtons family sending videopics phone juicethis galmy blackberry beast	AHKru
maggieyepes teohalbert behalf ms yepes colombia love	AHKru
goalllllllllll fra atta ladies	AHKru
organized peloton morning olympics	AHKru
nutritionist days thankstips justsayin	AHKru
link catwalk woman carine roitfeld genius	AHKru
marissa mayer big things silicon valley ladies things yahoo	AHKru
better summer north fresh clean	AHKru
canada day euro final tis good day azzurri final soo bound boom win celebrate	AHKru
carlyweeks elevenpr bridging gap pr pros journalists read note pr folks	AHKru
serious marketing chops mega talent courtesy gavinslate theellenshow listening sign	AHKru
dear german language lessons ssen schneller lernen brain	AHKru
hope deck hockey lot popular cali kings success season	AHKru
gebt mir ein super deutschland super deutschland hey hey dfb elf uefa	AHKru
this love smartphone tactus crackberry	AHKru
mediaobsessed wow major oversight forgot lead singer crucifictorious full price full price	AHKru
singyshih omg lol	AHKru
lakings brutal period nice rally nhl playoffs	AHKru
monster episode girls golf claps lenadunham fantastic	AHKru
mediaobsessed hanging head shame dare glory days	AHKru
aliceluong fret biblical sense	AHKru
wait puppy beauty bb jam teamblackberry	AHKru
elusivebalance lol best friend surprised bf wtix fan couple weekends ago sign true love	AHKru
pens pens pens	AHKru
beauty win bayern munich real madrid championsleague	AHKru
jbkruschack ha bro	AHKru
followers canada ontario toronto	AHKru
happy easter buona pasqua frohe ostern	AHKru
game thrones north remembers tonight gameofthrones	AHKru
gaga loves blackberry pretty bold bebold teamblackberry	AHKru
love soo ppl talking tanning lol	AHKru
happy pi day tweeps	AHKru
np explosions sky takes dillon texas forever	AHKru
toronto gorgeous day thankful living lake shore beauty	AHKru
isragana will wednesday hang lol	AHKru
euro matches june will busy days die mannschaft azzurri action going hameurocupstyle	AHKru
np tumbling dice rolling stones good	AHKru
mariorocchetta heard whatsapp	AHKru
aliceluong market glad investing studies alice lol	AHKru
bruno mars figured trick shorter bigger hair magic	AHKru
aliceluong entire learning theme semester kudos	AHKru
aliceluong soofood to hometown basically mecca italian calabrese food canada good	AHKru
lookin good toronto	AHKru
discarding livestrong bracelet todays events	AHKru
isragana watching horrible bosses	AHKru
aliceluong lol playlist strictly catering amazing songs montel jordans lol	AHKru
times changin rim bebold	AHKru
whoa discovered pan mode blackberry hah loving love torch	AHKru
isragana excellent festivities yesterday crimson carpet lives	AHKru
liking coachella roster lots bands bill check dr dre closing hello	AHKru
great evening best excellent kick year solid hangout	AHKru
mariorocchetta mine wear sweet surgical booties going shoeless swag	AHKru
arrested development marathon mind	AHKru
loving blackberry bebold spots times square forget niveas kissed bold people teamblackberry	AHKru
good morning sault ste marie fresh	AHKru
hair coffee baileys jayme best hairdresser	AHKru
aliceluong hah best megacoldplay fan tix to july super excited	AHKru
freezing rain move outta plane catch tmr	AHKru
aliice hilarious retweet	AHKru
favorable contribution bnn analyst response cont	AHKru
jeanettejenkins happy birthday ada cutie	AHKru
facebook feed love vid cats	AHKru
big congratulations fosterthepeople grammy nods	AHKru
mail excited nerd	AHKru
nice goal sullivan pens pens	AHKru
loved lssu shoutout pens game commentary sault	AHKru
mariorocchetta mar aint cute webisodes lol	AHKru
love choosing christmas cards small pleasures life	AHKru
bit tough pill swallow alas bit truth	AHKru
aliceluong blame big finance brains snacky lol	AHKru
mediaobsessed long snarkathoncatch session	AHKru
hey bb users rim launched bbm music today canada australia check	AHKru
people excited wrong celebration forget nov aka day halloween candy marked hello	AHKru
mariorocchetta hankering proper school basils semi kind outing	AHKru
np louder david guetta ft niles mason	AHKru
kicking week hr day tomorrow mad going ham earnit	AHKru
demi moore sandwich thinks hungry	AHKru
man man feeling sluggish today coffee stat	AHKru
fall term thanksgiving midterms	AHKru
greetings intl distribution class worse bruised banana gross lmfao	AHKru
cnn live stream mic journalist	AHKru
toronto left northern ontario foolishly expecting weather warmer degrees	AHKru
understood logic car sound system	AHKru
kind feel belle secret diaries call girl waiting lobby intercontinental toronto friends lol	AHKru
lovely evening ahead studies thanksgiving	AHKru
dear international distribution trade knew love whatttt	AHKru
tonight dinner yorkville friends tomorrow milton celebrate wone bests	AHKru
kaymichl puts tax bracket watch revenue canada	AHKru
staring contest gonna blink	AHKru
liking foot locker ads educators tv spots	AHKru
rip jack layton thoughts family friends canada	AHKru
family flippin amazing love grateful wanted share	AHKru
great night catching lagalaxy game tsn wacky wings wcoachkhamilton terr	AHKru
rupert murdoch suspect wanted legacy	AHKru
enjoying prefall event piperlime hot steamy hard rich heavy fabrics	AHKru
time love watch spaceshuttle launch happy friday	AHKru
amandarubin big willy style drove lcbo hahaha	AHKru
canucks bring cup canada louuuuuuu	AHKru
melindatravis add awesome post check saskatchewan rough riders cont	AHKru
joyvbehar day kinship ladygaga share threw commercial gyno talk lol hilarious	AHKru
annapolitoo anna going hit tweet goodie	AHKru
blackberry bold wildhmm upgrade torch	AHKru
dear colin firth dapper time love amanda metgala	AHKru
congratulations best wishes william kate royalwedding	AHKru
wow wow wowtoews	AHKru
happy playbook day	AHKru
gohabsgo omg game bruins sit downnnnnnnnn	AHKru
hope stanchion design works	AHKru
amandarubin spoils border town livin kw florida baking degrees today	AHKru
nm tweet wplayoffs corner habs nhl good night	AHKru
excellent hang time dianamedaglia	AHKru
happy april fools day hope filled tomfoolery big happy birthday shout cat fat oskarhope snacky	AHKru
loving trailer born wild minutes	AHKru
wthe great news enjoy playbook advert april ppl rim blackberry	AHKru
super moon super moon	AHKru
mom leaves brad	AHKru
great time capital rained snowed hrs canada sidenote family amazing hilarious	AHKru
mediaobsessed agreed cmon painful sit wanted throw things anne hathaway james franco	AHKru
mediaobsessed hey it	AHKru
thisisfrances larasutherland friends gals smutty tv watchers unite	AHKru
crazy february weather today note hibernating	AHKru
today good day current sugar high delicious cadbury creme egg feelin good	AHKru
hey trubies celebrate valentines day trueblood style hbo	AHKru
arcade fire win yay canadian music scene epic sweet babies	AHKru
keener chapped read tweets lot spellinggrammar mistakes	AHKru
thisisfrances pageants northern ontario mother killed tomboy wgood hair	AHKru
morning turned samsung captivate caught eye bc glossy huge	AHKru
forward superbowl excitement compare cup hysteria	AHKru
going crunches bed jeanettejenkins hard woo	AHKru
mariorocchetta mario writing valentines day cards lol	AHKru
steel town gosteelers	AHKru
enjoying piers interview ricky gervais	AHKru
showing lea michele fuss throw thingsat specificallythx	AHKru
heard skate fendersthe nhl hasgr things coming local businesses team lakers	AHKru
blackberry blackberryscene favorite adi perfect clutch will better wa playbook	AHKru
nelson passport stamped canadian benchouch wjhc canada	AHKru
yay official auntie matteo ben born evening pm mommy baby great	AHKru
ryanpyette seaofred trending topic happen canada worldjuniors	AHKru
takes strong man love funny woman justsayin	AHKru
happy birthday cuz dianamedaglia great day	AHKru
curtoneil stickin man	AHKru
mls finals today going great game	AHKru
loving video ceelo amazin pc mxoxbwiu	AHKru
hmcanada online shopping canadian customers	AHKru
fav costume april weather complete wyellow jumpsuit camcorder bbmattk antonio tmnts	AHKru
friday night lights perfect night fnl	AHKru
playbook demo adobe max conference check vid	AHKru
hello sugar high good night sugar crash	AHKru
curtoneil agreed today crappy fall day	AHKru
watching chileanminers one amazing stressful reason amazing	AHKru
loving pat burns coverage intermission	AHKru
guessing brett favre fact retired radar penis	AHKru
hello cold early fall season busy week geeze	AHKru
melissacugliett yay footnotes price point torch wow factor pimp phone	AHKru
bummed true blood wait season trueblood	AHKru
happy birthday tv guru mediaobsessed snark flow today	AHKru
going good week madmen set pace week awesome	AHKru
day awesome moosh	AHKru
littlecitymusic awesome congrats guys	AHKru
road tomorrow leave	AHKru
mandydennison hilarious beasty monday	AHKru
williamryounce love dr pepper	AHKru
qualified qualified hanging	AHKru
mediaobsessed keepem comin crazies	AHKru
feel shaq going play celtics meh	AHKru
tony robbins talk ton spit mouth	AHKru
good biz sports biz book read suggestions	AHKru
mediaobsessed time head suburbs	AHKru
woke meditate morning whatishappeningtome	AHKru
curtoneil check pizza	AHKru
bummed missing robynkonichiwa tonight pontiac mi hours north	AHKru
singyshih fast track phd lol	AHKru
pics carrie underwood honeymoon tahiti beachshes full face makeup carrie lamewash face	AHKru
monday help smile	AHKru
ouff yellow cards min settle boys worldcup	AHKru
mariorocchetta hear ya going hate lbj referred third personthat point seacrest	AHKru
curtoneil great photos curt scenery aint shabby lol	AHKru
iceberg radios malibu rum spot songs summer great crosseyed monday	AHKru
predicted win ger hey	AHKru
katrinakaye confirm things true happy canada day	AHKru
soccerbyives agree spains going esp hope fernando torres find stride againlove watch play	AHKru
prince highlight awards fake love love love prince betawards	AHKru
kevin connolly aka eric murphy entourage nhl entry draft art imitating life lol	AHKru
melissacugliett appear play today french lol	AHKru
hour kickoff worldcup	AHKru
marchetti nessuna pressione forza italia	AHKru
mediaobsessed hate accelerate quoted smash	AHKru
tsn best germany merciless thumping australia del bosques radar watch torres	AHKru
alright alright ready burst excitement link qyp denrwfeature playerembedded	AHKru
win baby wednesday night lookin good	AHKru
feel chilled buddha watch hills	AHKru
mediaobsessed slipping angry place heat idiots surrounded probs	AHKru
fan lost finale solidified wtf pos	AHKru
vino question hmmm	AHKru
mediaobsessed fbook bbm bit foul mood boot	AHKru
habsssss love mtl	AHKru
betty white snl epic	AHKru
amandarubin true blood love thee	AHKru
mariorocchetta dream pursue mar	AHKru
tan year dermatologist	AHKru
deny totally rooting tiger	AHKru
july soo you	AHKru
wonder beyonce realizes lame compared gaga worlds lame poor thing nice	AHKru
screw st patricks day patron saint vodka day	AHKru
mediaobsessed watched loved definitely season finale fack	AHKru
roll bed bout mid day hit blunt hit to place	ATMXO_
eagerness bubbling sun returned aries	ATMXO_
unexpected changes plans prove enjo aries	ATMXO_
yelllllllow diamonds lightttttttt	ATMXO_
hate pll will watching finishes	ATMXO_
markpersaud psht obvineed sweet tarts duh	ATMXO_
art understand beautiful exist	ATMXO_
looked cuter dark lol	ATMXO_
wanna knowcuz heart	ATMXO_
devikathakur probs girl anytime tweet felt deja vu	ATMXO_
devikathakur files legit chances man	ATMXO_
twelveofspades baybeehmiina rapists man	ATMXO_
devikathakur happened cried tbh resort plug computer asap	ATMXO_
carmennirvana tattedkisspers crying	ATMXO_
hear tone friends voice le aries	ATMXO_
tbt time head stuck railing time finger stuck ball farihah	ATMXO_
cold goddamn smoke	ATMXO_
baybeehmiina cost tuition set decrease real doable	ATMXO_
natural inclination spontaneous justi aries	ATMXO_
u suitcase rii coulda helped sista movin leaving	ATMXO_
allmagobbowbiyouorai baybeehmiina ariellenancoo nittykumar	ATMXO_
hello niggas wanted muthafucking caesar salad dressing fork	ATMXO_
realistic goals today enabling sa aries	ATMXO_
hate fucking bus	ATMXO_
year sister instagram	ATMXO_
acknowledging ambitions emotionally satisfying aries	ATMXO_
carmennirvana man niggas acting insomniacs	ATMXO_
bro funny live cry frustration	ATMXO_
baybeehmiina couldve called fam realize ability lmao	ATMXO_
emotionally conflicted today aries	ATMXO_
surfing waves change concentratio aries	ATMXO_
baybeehmiina kim talk problems	ATMXO_
wisest woman alive thing that plato	ATMXO_
tizzy storms appearin aries	ATMXO_
moment turnt listen chutney indian music current mood	ATMXO_
course wake late day classes	ATMXO_
course girl work frigin sit pretty occasionally cardio	ATMXO_
shantaafantaxo happy birthday beauty hope amazing god bless	ATMXO_
td happy birthday girly	ATMXO_
fucked movie love	ATMXO_
wow fast jeez	ATMXO_
kitinaa love ya tons stargyal	ATMXO_
goddamn feel columbia rn	ATMXO_
packed punch today powerf aries	ATMXO_
annoyed circumstances today aries	ATMXO_
baybeehmiina wake aii okaybiee	ATMXO_
baybeehmiina picchu nutshell	ATMXO_
baybeehmiina bc nat dere	ATMXO_
assume will turn dynamics wor aries	ATMXO_
enamored clever conversation today aries	ATMXO_
kaitinpls allo dere	ATMXO_
fucking man fuck	ATMXO_
markpersaud better thing tn btw	ATMXO_
cling practical notion relationships aries	ATMXO_
bumps road life smooth anot aries	ATMXO_
matter hope today workrelated tasks demand aries	ATMXO_
anils tbh loved class lmaoo	ATMXO_
xxshaneeza lost happy birthday baby girl hope amazing filled love joy god bless	ATMXO_
carmennirvana love mad bc senti	ATMXO_
hold ten minutes knock payment	ATMXO_
accustomed repetitive waves energy aries	ATMXO_
gained letting anger distract fro aries	ATMXO_
twelveofspades sarcastic asshole type opinion though	ATMXO_
twelveofspades evaluate aspects choose carry	ATMXO_
vote plz yaz	ATMXO_
ready personal agenda aries	ATMXO_
ain mad wanna bodyyy	ATMXO_
lowering defenses easy people aries	ATMXO_
sairahassan wah gwan lilo	ATMXO_
wanted popular ten followers	ATMXO_
great article dmventures	dreamakerrealty
prices lofty studios buildings renting month	dreamakerrealty
rising housing costs push poor households work attractive places interesting points	dreamakerrealty
bank fundamentals hypespeculation	dreamakerrealty
south view floor floors dream residences yorkdale yorkdalestyle	dreamakerrealty
catch dreammaker team cbc weekendcbc cbc cbc newsrealestate	dreamakerrealty
toronto mega projects set completion nice work blogto yyzre reinonmorefundamentals	dreamakerrealty
feet undergroundon sitedream residences yorkdale	dreamakerrealty
youtube video young jeezy autobiography album	dreamakerrealty
bubble bubble toronto condo sales booming globeandmail	dreamakerrealty
youtube video mcdonalds happy meal drivethru mcdonalds toys review mike mozart	dreamakerrealty
truck arivedtime pouryorkdaledreamdreamresidencesatyorkdale	dreamakerrealty
skyrocketing london real estate	dreamakerrealty
building phase dreammaker incinvestmentimmigrationhomeownership changings lives building relationships	dreamakerrealty
tridel aqualinacondos check aqualina facebook photo gallery forward early access	dreamakerrealty
god glory chapter startcant dreams grantedbiggest close yrs biz yorkdale	dreamakerrealty
refreshing praise worship start dayclears mind mensfellowship rccg	dreamakerrealty
rules prudent investing successful investing simple rules	dreamakerrealty
thought day famous failures mind work week dreammakercorp	dreamakerrealty
vancouver expensive city live north america	dreamakerrealty
thx god start love support family partners investorsrealworkstarts	dreamakerrealty
wake yorkdale test drive teslatry rolexwatch movieeat joeyswalk street yorkdale dmd	dreamakerrealty
speak real estate weath launch topic dreammaker team future development yorkdale	dreamakerrealty
bnn td chief economist craig alexander calls par canadian economy expects growth year	dreamakerrealty
foundation event ambassador zimbabwe ottawa dreammaker team started speech donation dmr	dreamakerrealty
asian wave invite screening remembering powerful moviehighly recommend	dreamakerrealty
life live american dream eh jude lol dmr realestate insideinfoonstocks lol	dreamakerrealty
great article yorkdale mall expansionthe dreammaker team excited article stay tune dmr	dreamakerrealty
sacks ave jokei hope rumors true coming yongebloortochanging	dreamakerrealty
award nightplanetafrica dmr winning	dreamakerrealty
andrewlafleur paper project you stay bmo mortgage	dreamakerrealty
toronto heading level newhomebuyers billion plan downtown toronto wordwow	dreamakerrealty
time york trideldont hype project will sell msg access brokerspublic	dreamakerrealty
globeandmail ban bank mergers helped canada withstand crash imf interesting	dreamakerrealty
game setup leadership forum nigeria high commissioner canada dmr	dreamakerrealty
dreammaker team playing yrs mirvish team dmr	dreamakerrealty
realized today jude will agree dreammaker team excited thing scares pple lol	dreamakerrealty
ufsctoronto anytime forward conf great team connect speakers crowd	dreamakerrealty
great article reality canada long term maximize info	dreamakerrealty
great trip team montreal check hottest project montreal stay tunedmr	dreamakerrealty
time contact details	dreamakerrealty
jb best months left beast modethe team won race quarter gonna fun	dreamakerrealty
real estate game chess dreammaker team will yelling check mate dmrtakeover amjustsayn	dreamakerrealty
uploaded youtube video dream maker corporate video	dreamakerrealty
bad news individuals companies understand real estate long term buying	dreamakerrealty
invested real estate fund global crisesthey understand real estate potential	dreamakerrealty
condo bubble toronto rbc report ahhh man forward drop buy	dreamakerrealty
demand commercial office space downtown plays employment demand downtown fundamentals	dreamakerrealty
daygetting ready speaking engagement youths rushing downtown sign deals free cruises dmr	dreamakerrealty
love game workpleasure dmr	dreamakerrealty
realdonaldtrump opportunity missed people dressed overalls work thomas edison love	dreamakerrealty
patio liberty villagehave meetingseatsoccer gamewhat daylol	dreamakerrealty
joelosteen god wouldn dream heart didn plan bring pass true powerful	dreamakerrealty
reinresearch europe china economic clouds continue darken economy gdp	dreamakerrealty
great day rbc golf event investors bankers workpleasure dreammaker	dreamakerrealty
work pleasure dreammakers june dreammaker stage wms dickinson dragons den	dreamakerrealty
pamam site liberty village steroids	dreamakerrealty
order couple dp pinscause gonna crazy drive dp	dreamakerrealty
montanasteele biggest thing happen toronto urban vision huge investors ready	dreamakerrealty
great event nevcan brunch la contessa topic building generational wealthgood chat whon consel general st kittsdmr tour	dreamakerrealty
lifetimedev quick meeting libertymarketbuilding sun shining libertyvillage today yuppp	dreamakerrealty
viewi love unit build lifestyle real estate wdreammakers	dreamakerrealty
jade waterfront projectlaunchthey start tonight signing saturday	dreamakerrealty
vip broker event casa loma south hill madison projectshould good onesome great left market	dreamakerrealty
miaoooooo game sooncongrats seun legal rep dmr chris agent dmr bidemi consultant dmrled team st quarter	dreamakerrealty
choices hot project dream maker team	dreamakerrealty
bildgta susan wong lots buying restrictions chinese market people investment	dreamakerrealty
uploaded youtube video dream maker realty annual black voices conference	dreamakerrealty
buy sell gtaresidential commercial dreammakers help	dreamakerrealty
mannn good weather going liberty village work easier lolso bricks flipped springsummer market	dreamakerrealty
market highinventory highdebt highbmo cares drop yr yr fixed rate confusion market	dreamakerrealty
stock market insider trading illegal real estateits create wealthhottest quote dean	dreamakerrealty
chance buy yorkville jv buy secured high return fund yrs brokerage access units bf vip	dreamakerrealty
nsbe mcmaster event wthe dream maker team speak business growanother day dream makers realestate	dreamakerrealty
st session huge hitgreat job marcel toronto real estate clubget signed asapif wanna build wealth real estate	dreamakerrealty
gzzz snow everywherenot stopping heading east wclients check acres major developmentdmr real estate	dreamakerrealty
honor featured university toronto side heavy donorsas community bar higher	dreamakerrealty
toronto individuals population built dwellings ppl pop	dreamakerrealty
turn ontario place casino ontplace real estate prices downtown job creation	dreamakerrealty
heavy newsbuild members contributed city employed	dreamakerrealty
unit rented queen west bed locker brand dream dealrented hrsfor hydro deal	dreamakerrealty
wait government determine retirementstart nowplant seed investments	dreamakerrealty
joelosteen find people godinspired dreams people will build celebrate victories	dreamakerrealty
good job fm owner st black owned station started	dreamakerrealty
good bad market invest real estate build wealth brainiera brainier pushy lol	dreamakerrealty
financialpost boc rate hike poll smell opportunity sight chaos	dreamakerrealty
watchn big fail hbo day interesting watch movie timeseven daughter enjoys lol	dreamakerrealty
joelosteen happy year faith step season gods goodness exciting year favor life	dreamakerrealty
great job globe mail media outlet tells it isand explains true todays mrk	dreamakerrealty
raptors game min game	dreamakerrealty
maternalgoddess comingi appreciate gift will big year businesses	dreamakerrealty
party startcrowd lot loveeven lil princess	dreamakerrealty
planning dreammakers xmas partyneed love clientsagentsconsultants big year	dreamakerrealty
weekgot big players consultantsfinished signing worth investmentsgood job dreamteam year	dreamakerrealty
thx god weekjust morning meetingthe dream team putting great work	dreamakerrealty
dream project dream maker realtyno marketing units leftlol stay tune tonight	dreamakerrealty
great article urbanation buzzbuzzhome condo bubble toronto forget key	dreamakerrealty
presentation banger thx godnow acce business forum business crossover canada chinabuilding relationships love	dreamakerrealty
blackbizpro postit great stage movers community	dreamakerrealty
oshawato watch oshawa powers ball nbl	dreamakerrealty
lunch meeting picton mahoney asset managementhedge funda tool wealthy wealthierinteresting	dreamakerrealty
happy bday wife best friend	dreamakerrealty
good articletoronto dubai nope country business forbes migrating	dreamakerrealty
talk wellthanks mdot setting uprogers tv pm pmwe moving stopdreamfund	dreamakerrealty
karlynpercil clients friends	dreamakerrealty
dream team ownership oshawa powers national basketball league come support team	dreamakerrealty
challenge dreamfund stocks better real estate resale preconstruction close fun	dreamakerrealty
winsonchan specific fund builtwaiting downtown project tridel	dreamakerrealty
happy bday princessk	dreamakerrealty
dreamfund presents year land development prime location investorsget yearly return total profitexcellent referral program	dreamakerrealty
game draft started	dreamakerrealty
boatswain today pmcontact ufsc space thx	dreamakerrealty
market drops percent dreamfund signing partnership international investment firm structure land units	dreamakerrealty
shout newest member joining benz teamsoon street will selling mercedesi reply	dreamakerrealty
shout ike vp operations dream fundmakes life easy dream team born readyoff biggest meeting	dreamakerrealty
golf trip barbados booked practice bf	dreamakerrealty
love game called real estatethe team firecant wait plates ride	dreamakerrealty
thinking hardnew company car dreamfund matic brand sclassthoughts	dreamakerrealty
officialover worth real estate purchased dream team unit selling higher floorsweet margins	dreamakerrealty
day dream makeroff meeting yachtreal estate creates lifestyles	dreamakerrealty
game international investors ready dream fund	dreamakerrealty
awudrick journodale course moot bc change require constitutional amendment blame jt	MacSweeneyG
hey alexboutilier pdmcleod stuartinthecage nacci thought troll you guys good cmaconthehill	MacSweeneyG
rickanderson channel news meant oath symbolism followers adhere oath	MacSweeneyG
terrorism treason citizenship apply	MacSweeneyG
laurapayton time catif pretrained kind save development costs straight production	MacSweeneyG
robfordmancs ldobsonhughes love comparisons nations canada instance	MacSweeneyG
graciestyle history confederation west shifted country time	MacSweeneyG
graciestyle good arguments east west pipeline beneficial convincingly	MacSweeneyG
laurapayton stuartinthecage gavmac paoconnell cmaconthehill suspect rachellemac	MacSweeneyG
stefcoinc emmmacfarlane laurentianu context	MacSweeneyG
pet lobster test hypothesis amazing	MacSweeneyG
love holy realdarrencohen will birth certificate	MacSweeneyG
great send probe surface collect data	MacSweeneyG
msbriggshdsb torontostar globeandmail media pillar dem responsibility democracy	MacSweeneyG
wheresmonica realdarrencohen hope guys enjoy night hanukkah	MacSweeneyG
oddly hand experience to face herd	MacSweeneyG
suppose ms clark enjoy good constitutional negotiation propose time	MacSweeneyG
stefcoinc bearded hipsters beware	MacSweeneyG
macsweeneyg heart moving piece tabathasouthey	MacSweeneyG
lisaraitt carful truth	MacSweeneyG
timhudak hey guys care power terms	MacSweeneyG
illinoisrider based credible science askachemist justplayoneontwitter	MacSweeneyG
mattgurney rowancaister terryglavin joshuahind situation ally france article	MacSweeneyG
illinoisrider study wrong surely writing prof piece difficult publish	MacSweeneyG
illinoisrider online publish comments truthful sort hurts integrity	MacSweeneyG
illinoisrider stefcoinc carlsonlabs goedomega forward reading papercommentary academic journal ind org	MacSweeneyG
stefcoinc illinoisrider chemist passing work carlsonlabs	MacSweeneyG
talk managing expectations	MacSweeneyG
stefcoinc phone call interrupted	MacSweeneyG
idea wonder security concerns showing process	MacSweeneyG
spartanvtyranny thomashall limit critique kind empty mention human spirit	MacSweeneyG
moot point experiment historical herenowneed decide ohsheri mattgurney russilwvong fullcomment	MacSweeneyG
ohsheri mattgurney russilwvong fullcomment argument sides	MacSweeneyG
realdarrencohen monica fun lower deck triangle	MacSweeneyG
realdarrencohen hey things	MacSweeneyG
time television remember slow ethicsblogger	MacSweeneyG
acoyne bcheadle enjoy	MacSweeneyG
agmacdougall light hope lawmakers	MacSweeneyG
fully endorse agree tweets ilyesimola shared noahrichler jennifer lawrence comments rts endorsement	MacSweeneyG
professional public service	MacSweeneyG
emmmacfarlane nspector elizabethmay popular support arbitrary point grant answer	MacSweeneyG
cmaconthehill gavmac paoconnell stuartinthecage hold second told sponsorship money	MacSweeneyG
pdmcleod word cpchq candidate active turfed elxn cpc	MacSweeneyG
good piece laurapayton nice background players the scenes	MacSweeneyG
find bit minister dedicated refugee asylum interesting petermackay good	MacSweeneyG
surely pissed fantastic opportunity	MacSweeneyG
nspector compassion compassion motivate action	MacSweeneyG
alcohol pm help talking break provincial tariff elxn	MacSweeneyG
nspector trilliumflowers brucelogan discussing issues pertinent population fish debate upfordebate	MacSweeneyG
mdentandt brianmarlatt constitutionally speaking administratively live prov	MacSweeneyG
gavmac stuartinthecage cmaconthehill paoconnell guys today kids blast	MacSweeneyG
interesting article pursue animal trophy bag true measure hunter	MacSweeneyG
pretty pension tax ma economics	MacSweeneyG
gandalfgroup kathleenwynne mitziehunter businessinsider fraserinstitute	MacSweeneyG
laurapayton laugh bankruptcy easy	MacSweeneyG
kinsellawarren fuddle duddle derivative flumaddle	MacSweeneyG
robsilver natnewswatch internal matter lot	MacSweeneyG
great read afraid terrified scottreid jandrewpotter matter	MacSweeneyG
journodale second time today ministerial resources beat justintrudeau gmbutts	MacSweeneyG
mikepalcanada jasonfekete stephentaylor hope transparency funding pacs	MacSweeneyG
emmmacfarlane justinling markdjarvis abolishing senate will concentrate power pmo	MacSweeneyG
watchctvnews robertfife ctvqp scc senate reference clear action requires constitutional change	MacSweeneyG
realdarrencohen realize heart broken heart broken week february	MacSweeneyG
seriously zionism outrageous fifagate	MacSweeneyG
leftardhockyguy actiongeologist free speech fully responsibly compatible moral judgment	MacSweeneyG
great story victoria day digging queens english	MacSweeneyG
natnewswatch bbcworld wonder pmo reaction kerry called state dept	MacSweeneyG
goalie save answer shot support goal redwings	MacSweeneyG
pharmanews cardionews amermedicalassn seekingalpha americanheart escardio cardiology cardiologytoday pvo	MacSweeneyG
jim prentice roll budget joe oliver bc good copy edit	MacSweeneyG
hollywood sins vans warped tour battle bands cmaconthehill hollywoodsins spread word	MacSweeneyG
trudeausteam inklesspw althiaraj therebeltv robot political leader shame cndpoli	MacSweeneyG
mrsinisterlefty laurapayton consumer preference exec left will sell	MacSweeneyG
mrsinisterlefty laurapayton assume business views include peopleemployees small minded view business	MacSweeneyG
torontostar buy beer beerstoreboycott blackmailing customers monopoly disgusting	MacSweeneyG
agmacdougall nice razors ockhams hanlons	MacSweeneyG
chastonb fareestweetable ctvmercedes guys sit polling booth vote proper freedom	MacSweeneyG
freedom expression mlse banning charged seriously hockey jersey	MacSweeneyG
shauntanakays surely changing institutionsystem easier mandatory voting	MacSweeneyG
realdarrencohen mistakennot scalia house majority whip scalise	MacSweeneyG
communicate good idea carbon pricing ethicsblogger mentioned sort honstephanedion intrst	MacSweeneyG
toronto man heartbroken statues stolen parents gravecmaconthehill laurapayton stefcoinc	MacSweeneyG
deal poutine dinner glass rye pint canadian cmaconthehill yrs	MacSweeneyG
problem isis serbia air strikes work will retreat	MacSweeneyG
acoyne robsilver anymorehe touched mouth lungs crwd blood	MacSweeneyG
stefcoinc eat apple poland share putin eatpolishapples	MacSweeneyG
acoyne philosophical question frankfurt	MacSweeneyG
medicalfood interest pivotalthr announces patent omega medicalfood vascazen obesity diabetes cardiovascular	MacSweeneyG
paul martins story lol sophia wanted explain funny	MacSweeneyG
maclean hill episode cmaconthehill sounding good	MacSweeneyG
lol sister basic	MattSkiing
reasons move whistler ski bike golf paddle	MattSkiing
entered win razer blackwidow tournament edition chroma keyboard	MattSkiing
perfect exactly planned argument	MattSkiing
year teaching skiing guys	MattSkiing
cs cobblestone case opening hope dragon lore youtube	MattSkiing
dancing semi cringe	MattSkiing
thislsamazing samsung apple samsung products better	MattSkiing
awesome friends feel	MattSkiing
time year long walk short pier	MattSkiing
discover great free apps rewarded gift cards freemyapps	MattSkiing
entered alpenf hn docm overclocking bundle raffle	MattSkiing
hd cable ps gonna relive childhood	MattSkiing
love metallica live pretty bad lars rushing song	MattSkiing
dammit love program impatient stupidest mistakes forgot write static wasted min	MattSkiing
crackadev georgedimech ilgdaily why	MattSkiing
os yosemite macs built gaming nice smooth	MattSkiing
vintagebeeflp sweet tickets man crazy games thanksgiving	MattSkiing
fascinatingvids stealing watermelon	MattSkiing
rush anniversary collectors edition blu ray hell	MattSkiing
guestwill week explorer going pathfinder	MattSkiing
cisky dw uruguay hungry winsuarez	MattSkiing
bike asap mcdonalds glen erin thomas pic	MattSkiing
bebopvox mod check lord rings mod	MattSkiing
vintagebeeflp info toronto meet	MattSkiing
happy birthday danielcalabres hope ski	MattSkiing
razer minecraft skyrim pokemon	MattSkiing
imagus chrome extension	MattSkiing
cisky happy birthday hope good	MattSkiing
officialnewss danielcalabres people better smh	MattSkiing
sickkk day moonstone bad yard sales greatday	MattSkiing
happy birthday jabuznik	MattSkiing
occording google marketing app year female	MattSkiing
ten pearl jam best albums	MattSkiing
yesssss tim card	MattSkiing
weekend nice christmas break	MattSkiing
join plugdj community	MattSkiing
check customdesigned dw drum kit created build lol great	MattSkiing
ohmzapp bad oo	MattSkiing
picture square wow	MattSkiing
guess time break drums	MattSkiing
therussky xjoshh dinnerbone troll	MattSkiing
omgfacts russia women outnumber men	MattSkiing
power night mom wake screwed	MattSkiing
ohmzapp xd bro spaz pills week contact russian noodles pasta chef	MattSkiing
lol apple dev site	MattSkiing
homework watch leafs bad combo	MattSkiing
kinda ditched twitter lol	MattSkiing
nickb lol win leafs	MattSkiing
dang find phone charger	MattSkiing
jabuznik texted lol	MattSkiing
twitter settings download view tweets website	MattSkiing
mattskiing regoinal weather man twitter signing	MattSkiing
darn pennies timetostartcounting	MattSkiing
lol watching top ten goalies wild power ouatge	MattSkiing
sick to sia	MattSkiing
omg bad hockey game	MattSkiing
watching bit golden globes	MattSkiing
watching future bell fibe tv pvr backtothefuture	MattSkiing
lol bet will	MattSkiing
gapergear armour hat	MattSkiing
lol lunches today	MattSkiing
ohmzapp ya nose job twitter	MattSkiing
concert real concert better grey cup	MattSkiing
wait watch national lampoon christmas vacation funniestchristmasmoivie	MattSkiing
wooah youtube update	MattSkiing
teen quote facebook	MattSkiing
holy cow mighty dwarf speakers best	MattSkiing
lol marians trench carly rae jespen justin bieber lip syncing badhalftimeshow gordon lightfoot	MattSkiing
jagzaga american apparel tank tops sold week lunches dontmissout jag	MattSkiing
wait grey cup goargos greycupsunday	MattSkiing
songsonshuffle body electric	MattSkiing
yeee tennis tonite	MattSkiing
lol music class life changing	MattSkiing
youtube mobile app awesome goodwasteofspace	MattSkiing
wonder twitter servers	MattSkiing
tweet madness bot account replies madness sparta	MattSkiing
followers live canada kazakhstan create map sick bogus	MattSkiing
sir francis bacon	MattSkiing
rogers demand working	MattSkiing
government hides stuff citzens	MattSkiing
xosamanthac profile picrute	MattSkiing
striploins whistler opens november	MattSkiing
ohmzapp mattskiin quantum rabieslol kind	MattSkiing
wow min number	MattSkiing
saved penalty kick	MattSkiing
copy paste textbook paper	MattSkiing
omygawsh hdjjhhjdjdjkdjkjkdjkl bdsjjwkeee best concert close bruce	MattSkiing
lol girl walking big dog tiny	MattSkiing
griffonc flying cincinnati ottawa pocket planes mac	MattSkiing
amacri suck loose game pentliys worst moment hockey truth	MattSkiing
omg guy blasting dubstep	MattSkiing
civies day row	MattSkiing
jakersgames bro class vid	MattSkiing
love twitter app mac	MattSkiing
exicted week going brucespringsteen concert	MattSkiing
gotta win today	MattSkiing
striploins thx pretty sick library wiht bobby	MattSkiing
best weekend great family	MattSkiing
fans throwing stuff field	MattSkiing
wow pile math hw	MattSkiing
check july bandpage bandpage	MattSkiing
hands kinda hurt rope	MattSkiing
yuumm burger king	MattSkiing
yeessss modern family tonight	MattSkiing
amacri loves retweeting	MattSkiing
samsungmobileus ya cares	MattSkiing
woaw early school	MattSkiing
stoked dad homade burgers	MattSkiing
gabbym ya fake	MattSkiing
academic english semester respond	MattSkiing
yee wifi school	MattSkiing
ughh internet failing	MattSkiing
best thing facebook changing language pirate	MattSkiing
money sports heart	MattSkiing
macrumors photos assembled iphone front panel button front camera shielding installed	MattSkiing
hahaha school rock good	MattSkiing
toronto soo awesome	MattSkiing
omgfacts numbers illegal troll	MattSkiing
paul blart mall cop	MattSkiing
finished third fourth parts lord rings today aka towers	MattSkiing
omgfacts word pixel contraction picture cell picture element mind blown	MattSkiing
lots water today	MattSkiing
awesome happy canada day weekend fbi il zscfeature youtube matthew mattskiin	MattSkiing
awesome birthday grateful awesome people life defintley best year	MattSkiing
post grad pics facebook	MattSkiing
ohmzapp thx tommorow	MattSkiing
wooah days till birthday	MattSkiing
happy skateboarding day	MattSkiing
yeeah sleep tommorow	MattSkiing
bet class going crazy rite	MattSkiing
mount textbook class	MattSkiing
people walk park skateboarding school	MattSkiing
finished gig song awesome spring recital	MattSkiing
guna busy day	MattSkiing
today will school wendsday	MattSkiing
xgames ultimate xgames weekend package pree sick grand	MattSkiing
full bars wifi work	MattSkiing
yeee school monday	MattSkiing
deystoy humans spent min deystoying city kill giant montser	MattSkiing
oddfuturetime playing baseball game time	MattSkiing
usa canada whict country better soccer match	MattSkiing
plan ahead time	MattSkiing
yaaaay tweet awesome followers putting	MattSkiing
people load house	MattSkiing
wooow to tweet tweet twitter	MattSkiing
day school atomic flush	MattSkiing
room messy tweeting definatly helps situation	MattSkiing
weell fail buses wrong bus wrong	MattSkiing
blbpt pokemon dies poisoned rite front pokemon centre	MattSkiing
bad luck brian pokemon trainer blbpt bad luck pokemon sitituion	MattSkiing
jolly rancher watermelon drink sooo bad sugary tooo	MattSkiing
wheather check twitter	MattSkiing
going xerris today	MattSkiing
thingstodobeforeidie skydiving ski alps	MattSkiing
omggg oddfuturetime ewlbow killing	MattSkiing
wow accounts follow tweets	MattSkiing
wayyyy voice cracks today	MattSkiing
guys blocked accounts	MattSkiing
woah cherylobl diary	MattSkiing
minuets day soo truestory	MattSkiing
big leauge chew	MattSkiing
macrumors apple moving inhouse mapping service views ios oddfuturetime will iphone	MattSkiing
smoking submarine dumbest idea everunless love smoke	MattSkiing
junoir achievment today hopefully shut day	MattSkiing
vimanala love neil peart insane drummer wait	MattSkiing
coyotes won mike smith goalie scored	MattSkiing
phone twitter day	MattSkiing
bobbybrown captain america ftw	MattSkiing
smh favorite trend things smh wonder nmh trend nodding head	MattSkiing
job going lookup bunch info ceo company undercover boss joke	MattSkiing
bills soooo sick	MattSkiing
omggg bussest song family sad	MattSkiing
phone collects dust crazy	MattSkiing
hope obsess weeks finals haha studentlife	Nounnno
tweet bismillah firsttweetforeverything	Nounnno
whyryerson politics government	RowanMMolloy
troyesivan toronto dates love you	RowanMMolloy
future chooseand mine exist	RowanMMolloy
setitoff youth djclymaxxx	RowanMMolloy
troyesivan knowing toronto dates troye	RowanMMolloy
troyesivan todayshow swimming pools	RowanMMolloy
troyestripod alljohnsondream troyesivan troyesivan	RowanMMolloy
greywater troyesivan sick	RowanMMolloy
troyestripod troyesivan troyesivan thinking march early april	RowanMMolloy
newrophanticss weather will warmer	RowanMMolloy
phanimist bethanymarie pray	RowanMMolloy
universalmusicc perf tour fridayyy youthvideo	RowanMMolloy
troyesivan babe youthvideo	RowanMMolloy
kpillar worst locker room game thegreatindoors	RowanMMolloy
troyesivan wait friday	RowanMMolloy
coreyvidal domestic cuisinart	RowanMMolloy
corradocoia better fedora	RowanMMolloy
raise wands houses alike ripalanrickman	RowanMMolloy
troyesivan hows day troye boy	RowanMMolloy
troyesivan heard radio turned king	RowanMMolloy
troyesivan waited long damn good	RowanMMolloy
kind days nanowrimo	RowanMMolloy
conflict final climax nanowrimo	RowanMMolloy
troye boy will february troyesivan	RowanMMolloy
nanowordsprints best sprint days	RowanMMolloy
time writing nanowrimo	RowanMMolloy
today write bit hey start right nanowrimo	RowanMMolloy
bright side will hit today nanowordsprints nanowrimo	RowanMMolloy
writing vforvendetta remember remember november nanowrimo	RowanMMolloy
long happy progress nanowrimo	RowanMMolloy
nanowordsprints day nanowrimo	RowanMMolloy
nanowordsprints forget novels nanowrimo	RowanMMolloy
corradocoia jealously wishing	RowanMMolloy
excited hang nanoprep	RowanMMolloy
full synopsis novel nanowrimo nanoprep nanowrimo	RowanMMolloy
mutantcanuck sounds exciting	RowanMMolloy
mutantcanuck friend invited lastminute	RowanMMolloy
hanging worldtourtoronto unsure feel great seats	RowanMMolloy
nostalgianinja nanowrimo love help nanoprep	RowanMMolloy
danbohobbes single setting pm takes hourhour half good day min sprint nanoprep	RowanMMolloy
hanging twitterverse october advice nanoprep	RowanMMolloy
brighthappyplnr nanowrimo character questionnaires helpful nanoprep	RowanMMolloy
kellyloygilbert therealdominia learned focused plans graphs nanoprep	RowanMMolloy
iamclockworx planning pants nanoprep	RowanMMolloy
missing land french tracks	RowanMMolloy
seriousrachel community support lots people including write anxiety looming	RowanMMolloy
saskiavanell buffer festival volunteers year cry	RowanMMolloy
simple title time start editing nanowrimo	RowanMMolloy
wolfgangvidmakr met sawyer october nice guy	RowanMMolloy
today small dosage medication enters system will fight anxiety time recovery bellletstalk	RowanMMolloy
switzerland destroyed russia tall alextwestlake wjc	RowanMMolloy
mapleleafs bounce leafs bounce tmltalk	RowanMMolloy
hankgreen donate help	RowanMMolloy
articulationsv hankgreen jobogro excited	RowanMMolloy
today finish school project nanowrimo title	RowanMMolloy
title ideas child powers powers young child	RowanMMolloy
saskiavanell family thoughts	RowanMMolloy
project awesome better start working partnersformh	RowanMMolloy
rhettandlink peter pan syndrome	RowanMMolloy
thechelseas thewritelist named guy jonathan arcore welldeveloped felt real	RowanMMolloy
day writing fair day garbage great	RowanMMolloy
happy people nanowrimo people press	RowanMMolloy
lovelockeprince good luck	RowanMMolloy
kinda write kinda dance sinatra music struggle nanowrimo	RowanMMolloy
marathoning rhettandlink videos writing good day nanowrimo	RowanMMolloy
alright time to work lovely nanowrimo novel	RowanMMolloy
kidding currently magic couch keeping story moving nanowrimo	RowanMMolloy
nanowordsprints bad nanobirthday	RowanMMolloy
nanowrimo birthdays goal today nanobirthday	RowanMMolloy
frinightwrites writeclub head nanowrimo	RowanMMolloy
tomorrows plan hit big halfway november day birth nanowrimo	RowanMMolloy
time start writinggoal hit todaynanowrimo	RowanMMolloy
mapleleafs weathertechca jvr tmltalk goleafsgo	RowanMMolloy
mcm connorfranta connorfranta youtubers youtube	RowanMMolloy
syaffolee whoo hoo	RowanMMolloy
time skipping chapter nanowrimo	RowanMMolloy
nanowordsprints distracted mom time open todd guess start living	RowanMMolloy
nanowordsprints party time	RowanMMolloy
kaylabriewilder ready write nanowrimo	RowanMMolloy
kaylabriewilder totally nanoprep	RowanMMolloy
thesprintshack prepping springs help lot exactly count	RowanMMolloy
kaylabriewilder write minutes day minutes day hours day honestly matter break chain	RowanMMolloy
cbj lead sigh gokingsgo	RowanMMolloy
corradocoia happy birthday	RowanMMolloy
voted tyleroakley homecoming king mtvnews homecoming homecoming	RowanMMolloy
rowan nervous hero role model inspiration charlestrippy bufferfestival	RowanMMolloy
gunnarolla seconds today picture fan great	RowanMMolloy
ucfh maureenjohnson wilw nightvaleradio best guy	RowanMMolloy
brother hates goleafsgo tmltalk	RowanMMolloy
coffee rain good book	RowanMMolloy
novelchronicle pretty year missed days freaked hours intense nanorebel	RowanMMolloy
kosmopoliteatd planning comfortable recommend laptop writers pen paper nanorebel	RowanMMolloy
sweater weather missed	RowanMMolloy
impaulgale thefinebros happening	RowanMMolloy
free tshirt designers kyle steed original invisionapp invisiontee	RowanMMolloy
today final day long hair goodbye will missed finally	RowanMMolloy
queenofheii emails day hopefully answer	RowanMMolloy
kernowtalay wilw playing ticket ride	RowanMMolloy
won campnanowrimo word winners circle campnanowrimo	RowanMMolloy
nanowordsprints bit careful mumbled threw zombie backwards	RowanMMolloy
frinightwrites pumped ready write	RowanMMolloy
wethetyler charlestrippy tyler favourite	RowanMMolloy
day filled drawings art drawing chill	RowanMMolloy
times joy pain afraid love big love full love remarkably love thefaultinourstars	RowanMMolloy
habs period goal pacioretty making playoff hat trick	RowanMMolloy
colangelodiana playing june pm aurora cineplex nightbeforeourstars check cineplex website	RowanMMolloy
will lakings feel blackhawks	RowanMMolloy
sporce nanowordsprints whoo	RowanMMolloy
seraheshoes pollypissypants minutes going going nanowordsprints	RowanMMolloy
nanowordsprints ready kill sprint	RowanMMolloy
nanowordsprints roll driving truck mall zombies fun amwriting	RowanMMolloy
takers word sprints nanowordsprints write	RowanMMolloy
nanowordsprints won nanowrimo friend loved terrible zombie novel years writing birthday	RowanMMolloy
waiting delayed trains fun rain	RowanMMolloy
happen pack omgrobots competition early	RowanMMolloy
begging counted tmltalk	RowanMMolloy
frinightwrites writeclub story picking slow slow speed minecraft distracting	RowanMMolloy
frinightwrites sprint hour ago brand projecteastman writeclub excited	RowanMMolloy
nespresso capital molloy house	RowanMMolloy
time wake willingly frc competition omgrobots	RowanMMolloy
spanky understand concept yelling screen jeopardy	RowanMMolloy
internethugs famous hug hugs	RowanMMolloy
twitter nice company watching superbowl whatisgoingon wheresthesnitch	RowanMMolloy
empty net goals feel gifts heaven goleafsgo mapleleafs	RowanMMolloy
will middle exam thefaultmovie trailer	RowanMMolloy
bellletstalk years to grips anxiety felt better itgetsbetter mentalhealth	RowanMMolloy
bellletstalk day bell will donate tweet hashtag bellletstalk promote mental health	RowanMMolloy
science notes science notes exams	RowanMMolloy
signed rightbyyou petition support youth mentalhealth suicideprevention join partnersformh	RowanMMolloy
nlibrisveritas adored easy to love	RowanMMolloy
god bobble john projectforawesome	RowanMMolloy
love you slow waitingwaitingwaiting	RowanMMolloy
comment tweet writing speak understand iusuallytalkaboutfood	RowanMMolloy
nanowordsprints validate novel writing final help nanowrimo	RowanMMolloy
will return won wanted frinightwrites nanowordsprints ericnentrup many	RowanMMolloy
mentioned massive disney fan helped love butseriously goseeit frozen backtonovelling	RowanMMolloy
ericnentrup congrats will joining tomorrow nanowrimo	RowanMMolloy
publishmidgard midgard kind wordstogo	RowanMMolloy
will huge stretch nanowrimo mintogo	RowanMMolloy
korbust real track close nanowrimo letusdothis	RowanMMolloy
incredibly cute scene min gotime nanowrimo	RowanMMolloy
adding extra chapter lift wc nanowrimo	RowanMMolloy
write tonight working will days imisswriting stupidblock nanowrimo	RowanMMolloy
hit yesterdays goal write hour hour half nanowrimo	RowanMMolloy
hit tonight meh nanowrimo	RowanMMolloy
fight plot slowing going sprints bit nanowrimo	RowanMMolloy
hanging admin office good purposes raffle great word count numbers nanowrimo	RowanMMolloy
nanowordsprints track nanowrimo	RowanMMolloy
early wake bufferfestival canadian bufferfestival	RowanMMolloy
pm pretty convient nanowrimo nanowordsprints	RowanMMolloy
wheezywaiter bufferfestival apprenticeeh shaycarl ctfxc	RowanMMolloy
nanowordsprints will hit tonight	RowanMMolloy
nanowordsprints excited sprints	RowanMMolloy
nanowordsprints hit goodwritingday nanowrimo goodtogo	RowanMMolloy
corradocoia will confirmation buying tickets	RowanMMolloy
bufferfestival vloggers november sold	RowanMMolloy
heyimissie alextwestlake agreed	RowanMMolloy
mackavaldez heyimissie tsbnick tlwk fond travelling tlwk thesequel amwriting	RowanMMolloy
seriousness turkeys apes movie called turkeys town ii revenge apes englishclass tsbnickyear	RowanMMolloy
funny fuel joke refuel whiletsbnick terrible joketelling iamfunny butonlysometimes	RowanMMolloy
alextwestlake lot good points	RowanMMolloy
mom happy laptop hear facebook going pinterest itsloud tsbnickyear	RowanMMolloy
sour cherry dealer literally notwhatyouthink theactualcandies tsbnickyear	RowanMMolloy
alextwestlake tsbnick heyimissie pandagal tweet movies noshame tsbnickyear	RowanMMolloy
assemblies worse truthful tsbnickyear	RowanMMolloy
prepped bowtie red pants coreyvidal gathering sunday excited	RowanMMolloy
chickwithpencil validate guessing winners open august st	RowanMMolloy
dog plothole justfixedit stupiddog	RowanMMolloy
day campnanowrimo ktogo kgoal	RowanMMolloy
campnanowrimo crazy finish weekend wewillsee feelinginspired	RowanMMolloy
campnanowrimo starts tomorrow ready notatall	RowanMMolloy
lose temper day	RowanMMolloy
realjohngreen hankgreen happy hanko de mayo facebook fans	RowanMMolloy
woo hoo voted win mybbb destinations ultimate rtw trip cash	RowanMMolloy
coreyvidal featured websitelivestream congrats guys	RowanMMolloy
nominating thelizziebennetdiaries thelbdofficial bestcomedyseries streamys	RowanMMolloy
corradocoia card post office samanthafall nanoing	RowanMMolloy
gunnarolla teamandrew going gathering tomorrow apprenticeeh	RowanMMolloy
kind love coffee trending canada	RowanMMolloy
tweeted tyleroakley live	RowanMMolloy
corradocoia tomorrows gathering official	RowanMMolloy
coreyvidal gathering officially saturday list going check channels	RowanMMolloy
gleeonfox time klaine	RowanMMolloy
special screening david documentary wednesday oakham house	RyersonU
whyryerson openhouse tour snapchat	RyersonU
whyryerson openhouse day	RyersonU
share photo city hall lit support ryersonrams weekend werrams	RyersonU
congrats coach werrams ryersonrams	RyersonU
ryerson trsmryersonu student maria poonawala shares ceo ikeacanada day	RyersonU
add microsoft excel list competencies drop rslc tomorrow quick crash course	RyersonU
alexncotrufo thing overuse	RyersonU
decision school attend fall ryerson openhouse march	RyersonU
game curious check untapped potential video games launchzoneru starting today	RyersonU
hey potential ryerson students join march open doors ryerson openhouse	RyersonU
rslc abuzz ppl hair dyed cut shaved makeawish raised	RyersonU
textbooks help child gain education find textbooksforchange drop campus	RyersonU
happy iwd forget join today pod	RyersonU
marsha brown will introducing annual viola desmond award recipients tonight	RyersonU
mattgallowaycbc exploring rslc cbc disruptingdesign catch	RyersonU
catch firstrobotocs place mattamyac weekend ryersonfrc	RyersonU
win tickets oua basketball quarterfinals march tweet pic robot ryersonfrc visit ruengineering booth mattamyac	RyersonU
interim president mohamed lachemi announces raised special help scotiabank sarabjit marwah rslc	RyersonU
anyssaclose find contact directory ryerson departments	RyersonU
st generation immigrant living peelregion survey shareyourjourney	RyersonU
vice provost hlv joins womens ryersonrams basketball team acting member oua glory	RyersonU
good morning open today classes running scheduled	RyersonU
multivursqueen monitoring weather closely working hard assess weather conditions clock	RyersonU
thanujaj updating website shortly stay tuned	RyersonU
fnr classes running scheduled monitoring weather will provide updates today	RyersonU
morning nserccrsng president dr mario pinto speaks power innovation ryersoncue	RyersonU
st generation immigrant living peelregion check survey shareyourstory	RyersonU
court top fragrance empire ben gorham reflects ram helped shape career	RyersonU
family second third generation ryersonian share story ryersonalumni	RyersonU
considering work study program thyear bio student nishara muthu arachchige you	RyersonU
celebrate openlearning insightful discussion developing online content monday trs	RyersonU
bit poetry celebrate rslcyr	RyersonU
itsnainai feeling love congratulations ryerson ramily	RyersonU
week campus check inventions light conference impact light creative imagination	RyersonU
xchickennuggets ryersonsafety additional details campus place	RyersonU
monitoring weather updates school closures will posted	RyersonU
ryerson president mohamed lachemi introducing premier kathleenwynne ryersondmz	RyersonU
daviddesa better night person perk	RyersonU
hello rslc team rslcyr	RyersonU
rslc turns best memories check daily favourites	RyersonU
game oua mens hockey quarter finals help protectthemac support ryersonrams puck drops pm	RyersonU
learn lifelinesyriaru ryerson involved helping resettle syrian refugees	RyersonU
campus reading week today check aboriginal graduate student showcase today mattamyac	RyersonU
experience experientiallearning changschooltalks follow changtalks updates	RyersonU
winter snap pic campus featured ryersonalumni holiday card	RyersonU
morida contact ruengineering schedule adjustments updates	RyersonU
learn experientiallearning years changschooltalks speakers workshops	RyersonU
winter care skate	RyersonU
business basketball insight wayne embry draft players based intelligence character talent order trsmryersonu	RyersonU
business basketball panel underway brought trsmryersonu special guests wayne embry matt winick patrick engelbrecht	RyersonU
follow dmzsession sharing economy live twitter ryersondmz	RyersonU
big norm stopping tonights ryersonrams mens hockey game	RyersonU
cheer ryersonrams mens hockey team tonight pm westernmustangs fanappreciationnight	RyersonU
time pod today daysdry	RyersonU
happy partnership tatapowerddl techmahindra support renewable energy generation storage	RyersonU
usetherightwords join discussion reporting sexual violence feb	RyersonU
live bttoronto rlsc	RyersonU
join timhudak ryersondmz wednesday dmzsession collaborative consumption	RyersonU
john ralston saul monia mazigh james turk discussed bill latest centre free expression event	RyersonU
snap ribbon cutting bombay zonestartupsind inaugurate space	RyersonU
akua benjamin public lecture pay tribute years activism resistance toronto feb blackhistory	RyersonU
hear development ryersons budget upcoming town halls feb	RyersonU
students faculty staff invited celebrate equity diversity inclusion feb alan shepard edi awards	RyersonU
alan shepard edi awards celebrate students employees advance ryerson values equity diversity inclusion	RyersonU
nominated board senate election attend mandatory student candidates session feb pm jor	RyersonU
find to job career compass ryersonu career job search guide	RyersonU
todays atkinson lecture ryersonrjrc marie wilson watch live ryecast	RyersonU
aahildayani start whyryerson info touch	RyersonU
congrats ryerson faculty alumni nominated canadian screen awards academynet	RyersonU
lifechanging experience meets longterm success ryerson learn	RyersonU
lifechanging experience meets longterm success ryerson learn	RyersonU
rsx will develop idea socialchange win cash rusocialventure	RyersonU
video ryerson students talk goals plans	RyersonU
idea socent connect innovators join rsx	RyersonU
join survivor skill share jan confidential safe space address safety campus consentcomesfirst	RyersonU
ready build city engage community rsx calling jan rusocialventure	RyersonU
search committee announced ryersons vp innovation search onpse	RyersonU
build community develop professionally foster leadership women planning forum jan	RyersonU
check immersive interactive exhibit ripple ryerson architecture students jan jan	RyersonU
ryersons school interior design named top design schools azuremagazine ryersonfcad	RyersonU
international issues discussion iid series hosts child soldier conversation michel chikwanine jan	RyersonU
things visit ricgallerys exhibitions work contemporary female artists opening jan	RyersonU
congrats ryersonmbagames second place finish mba games	RyersonU
update ryersons presidential search onpse	RyersonU
ryersondas professor vwhui honest eds toronto landmark top global buildings	RyersonU
university will closed holidays december january classes resume january	RyersonU
program ryersons school nutrition will improve food security children northern vietnam	RyersonU
state art buildings gold medals drake top ryerson stories	RyersonU
application graduate spring ramss ryerson	RyersonU
curious steps receiving transfer credit visit steps ryerson	RyersonU
ryersonexams announcement pm exam start time mtcc delayed pm subway delay	RyersonU
memoriam ryerson community members passed year	RyersonU
curious steps receiving transfer credit visit steps ryerson	RyersonU
ryersonima grad andrew cividinos sleeping giant screen canadas top film festival january ryersonfcad	RyersonU
burning midnight oil late night studying ryersonexams	RyersonU
join special dinner support ryerson university lifeline syria challenge dec syria	RyersonU
ryerson fashion comms student kelly ann nguyen true cost buying cheap clothes fastfashion	RyersonU
psych prof martin antony talks ctvnews social anxiety holiday season	RyersonU
simple things discloses sexual violence usetherightwords	RyersonU
curl kitty feel stress melt kitty cat corner dec	RyersonU
don chance share thoughts improving safety accessibility quality spaces campus	RyersonU
ushahzadi flagging decision rsu corporation wholly separate independent university	RyersonU
join journalists pr pros ryersondmz dec panel discussion startups media dmzsession	RyersonU
globeandmail valuable business lessons entrepreneurship ryerson learned classroom	RyersonU
ryerson half unitedwayto goal help involved	RyersonU
ryerson half unitedwayto goal help involved	RyersonU
join today flanders fields exploring renowned poem enduring impact pm mlc gallery gerrard st	RyersonU
confirm eligibility graduate officially graduated request letter ryerson	RyersonU
join ryequity panel guns violence women today pm	RyersonU
register guns violence women dec committee event gun violence cda ryersonedi	RyersonU
calling grad students enter word second video contests dec win prizes totaling	RyersonU
feeling ruff paws check rustudentlife video wonderful rutherapydogs program	RyersonU
apply letter permission plan courses college university ryerson	RyersonU
flu yearend projects exams flu shot clinics happening nov	RyersonU
december winter transfer credit deadline applied ryerson	RyersonU
check sustainability matters annual survey thoughts shape program	RyersonU
project torontohydro ecamion ryerson mount smartgrid battery hydro pole	RyersonU
ryersons trans day remembrance memorial will held today noon rslc ryersonedi	RyersonU
scottybawesome expecting complete undergraduate degree	RyersonU
congrats iambrennan alumnus ryersondmz startup canada young entrepreneur year award	RyersonU
good luck annu gaidhu ru student reigning india canada nominated ivhq volunteer year	RyersonU
davidbgrossman challenge david student art project contacted police assisted investigation good	RyersonU
apply letter permission plan courses college university ryerson	RyersonU
renowned choreographer james kudelka joins ryersonfcad rtsryerson kudelka meets ryerson dances	RyersonU
noticed needing repair cleanup campus heating cooling issue contact ryersonfixit	RyersonU
update community ryerson students studying france french exchange students ryerson	RyersonU
itsjusteniola terrific biomedical engineering biomedical science programs	RyersonU
melissaleila contact campus facilities ryersonfixit	RyersonU
hockey insider reporter alum tsnbobmckenzie receives elmer ferguson memorial award hockey journalism	RyersonU
ryerson global innovation challenge applications open nov create viable business ideas	RyersonU
students bring ryerson values toronto community neighbour project	RyersonU
ease exam stress ryerson moves free minute yoga meditation classes nov slc takecareru	RyersonU
prof amatthewsdavid talks nytimes dangerous clothes book fashion victims	RyersonU
ryerson global innovation challenge applications open nov create viable business ideas	RyersonU
student campus centre oakham house closed today water main break will reopen usual tomorrow ryerson	RyersonU
toronto region board trade honours business excellence award winners including ryersondmz canbizjournal	RyersonU
prof david atkinson will speak arctic climate culture spur nov ottawa	RyersonU
ryerson global innovation challenge applications open nov create viable business ideas	RyersonU
ryersondmz ranked st north america ubi global ranking ubiglobal startups entrepreneurship	RyersonU
join ricgallery exhibitions curator ga lle morel tomorrow tour weegee murder business	RyersonU
join cn tower stair climb united nov ruunited	RyersonU
join united cn tower climb help people move poverty possibility ruunited	RyersonU
icymi ryersons rooftop farm celebrates bumper harvest torontostar	RyersonU
pretty combination hustle humility mondaymotivation rumotivated	RyersonU
reminder participants nov apply attend years tedxryersonu conference	RyersonU
ryerson host toronto charity homeless connect mattamyac sunday nov	RyersonU
rutvnews covers kickoff event annual ted rogers management conference march	RyersonU
grad students enter grad word second video contests win prizes totaling ryerson	RyersonU
hear lively thoughtprovoking ideas walrusmagazine talk tomorrow trsmryersonu	RyersonU
reminder participants nov apply attend years tedxryersonu conference	RyersonU
crossover youth project help youth care stay justice system ryerson	RyersonU
free online webinar tomorrow highlights hiring bias visit details	RyersonU
gold medal grad daniel liadsky receives ryersons top honour roadfromryerson	RyersonU
ryersons united campaign pledges help community ruunited	RyersonU
rsvp tues info session ryerson professional masters diploma enterprise info privacy data protection	RyersonU
explore public cultural performance ryersonfcads performigrations exhibit friday	RyersonU
cricketryerson surpasses cornell harvard win american college cricket north east regional tournament	RyersonU
celebrate the growing season ryeshomegrown oct rueats snacks prizes	RyersonU
help support community donation united ruunited	RyersonU
rams womens volleyball opener brock oct share experience werrams	RyersonU
videographer adrian morphy reminds ryerson students vote difference exln	RyersonU
learn ryerson formula racing ryersons largest student design team today pm rcc	RyersonU
politics friends facebook friendships fare elections smlabtos elizabeth dubois investigates	RyersonU
theeconomist ranks ryersonmba top action whichmba	RyersonU
obanewss basketball life career symposium high school girls place saturday mattamyac	RyersonU
nelson mandela walk dedicated campus recognizing special relationship ryerson late freedom fighter	RyersonU
good morning special happen night	RyersonU
rsvp oct info session ryersons master social work program	RyersonU
nelson mandela walk dedicated campus marking special relationship late freedom fighter	RyersonU
launched united campaign help touch lives thousands people ruunited	RyersonU
goenggirl ryerson engineering hosts fun handson engineering program girls oct	RyersonU
ubercanada general manager ian black ryerson mba speaker series trsmryersonu	RyersonU
happy friday head thanksgiving long weekend friendly reminder ryerson will closed monday	RyersonU
attend oct open house learn master applied math ryerson	RyersonU
rsvp oct info session ryersons master social work program	RyersonU
check final farmers market gould st pm grab lunch fresh ont produce rueats appletreeto golocal	RyersonU
today victoria st bw gould gerrard will dedicated nelson mandela walk join ceremony pm	RyersonU
raise mentalhealth awareness celebrate mindfest ryerson quad tomorrow pm free food provided	RyersonU
interested health wellness attend mindfest tomorrow inspirational speakers yoga harthouseuoft	RyersonU
soup substance tomorrow noon pm podium pod room	RyersonU
social justice week visit info events ryerson	RyersonU
good morning join mindfest oct mentalhealth speakers workshops entertainment ryerson	RyersonU
nelson mandela walk dedicated ryerson campus oct	RyersonU
october cyber security awareness month check series events ryerson hosting	RyersonU
ripple nuitblanche designed ryerson architecture students grads incredible	RyersonU
smlabtos polidashboard reveals people federal election cdnpoli elxn	RyersonU
credit ratings budgeting planning life school learn personal finance skills rudebtfree	RyersonU
ryerson offers free financial literacy course students sign rudebtfree	RyersonU
politicians political strategists set discuss federal election trsmryersonu oct	RyersonU
happy day october ramily	RyersonU
nelson mandela walk dedicated campus oct ryerson	RyersonU
heard ryerson office equity diversity inclusion launched website ryersonedi	RyersonU
ruservicehub onestop shop student administrative questions	RyersonU
will donated trimentoring program tweet tmpturns tweeting ryerson	RyersonU
discrimination harassment prevention services officially human rights services ryersonedi	RyersonU
monicakwong time hard work monica ryersonouf	RyersonU
visiting ouf note dvp will closed weekend plan ahead ryerson	RyersonU
heard studentmoveto ryerson help improve transitwoes stay tuned week getmoving	RyersonU
quest sleep signs insomnia quotes prof colleen carney chatelaine	RyersonU
things proposed eu general data protection regulation anncavoukian	RyersonU
eat gain weight ryersons nextlaboratory investigates torontostar nutrition	RyersonU
architectural science welcomes awardwinning architect nasrine seraji tomorrow ryerson	RyersonU
happy arafatday observing	RyersonU
president levy ryersondmz innobhams global entrepreneurship initiative busnewshub	RyersonU
photojournalist weegees gritty york city images will display ricgallery oct	RyersonU
employee award nominations open nominate exceptional faculty staff member today ryerson ryersonhr	RyersonU
free community skate mattamy athletic centre sunday pm	RyersonU
royal society canada award sends immigration settlement prof harald bauder germany ryerson	RyersonU
ryerson students experience international learning amritaunivs livein lab	RyersonU
rucampusstore online ordering order online skipthebookline pick books	RyersonU
ryerson rises rslc cdnarch	RyersonU
top things didn career centre ryersoncareer	RyersonU
reminder ryerson will conducting fall fire drills legislative requirement buildings week	RyersonU
volunteer opportunity help ryerson aircanadacentre weday oct	RyersonU
studying engineering hightech career fair	RyersonU
monahcostantino signs ryerson group official statement	RyersonU
krisnas official statement matter ryerson	RyersonU
rivalthoughts official statement matter ryerson	RyersonU
executive chef joshnamaharaj talks cbcnews avoiding freshman ryerson	RyersonU
rusulalrubail offensive signs condoned ryersonu ryerson group report ryersonfixit	RyersonU
beesince offensive signs condoned ryersonu ryerson group report ryersonfixit	RyersonU
terrylknox offensive signs condoned ryersonu ryerson group report ryersonfixit	RyersonU
ellhah working remove offensive signs campus report location ryersonfixit	RyersonU
gpd working remove offensive signs oncampus report location ryersonfixit	RyersonU
colours blue gold ryerson	RyersonU
happy cityhall join npstoronto free celebration noon	RyersonU
great night ryerson supporting parkinsons choir ryersonsmartlab	RyersonU
babitasabrina congratulations mindandaction social media contest winner email ryersoncgcegmailcom details	RyersonU
reminder gould st closed ryesu concert plan alternative routes info	RyersonU
reminder gould st will closed today pm ryesu concert plan alternative routes info	RyersonU
fyi ryerson fashion students heads educanadauk	RyersonU
ryersonjohn high praise coming sir	RyersonU
watch masters alum chris chan work real explosives safer police ryerson	RyersonU
ryerson learn help succeed year	RyersonU
info ruonecard ryerson	RyersonU
blown mindandaction responses ryerson inspired	RyersonU
number university grads jobs increased ontario year cdnpse jobs grads	RyersonU
grab choice hotdog fruit cotton candy picnic quad noon pm ryerson	RyersonU
tomorrow ryerson community picnic quad noon pm	RyersonU
muoylek help contact ccs helpryersonca	RyersonU
reminder parking lot churchdundas will limited spots sept development	RyersonU
ramspride alumni weekend ryersonrams york lions ruaw	RyersonU
joyiach visit website	RyersonU
fall order online skip win gift card rucampusstore skipthebookline	RyersonU
good rutherapydogs campus	RyersonU
join prof george kapelos ryerson thurs free talk city hall competition ryersondas cityhall	RyersonU
congrats rtaryerson prof michael coutanche named ryerson fellow masseycollege	RyersonU
gearing ryersons annual guinness record challenge tomorrow join quad pm	RyersonU
meet years incredible rustudentlife oteam roadtoryerson	RyersonU
renewed commitment excellence sneak peak ryersons brand refresh	RyersonU
search president will anew october running fall winter ryerson	RyersonU
live tv students join corner gould victoria morning bttoronto prizes giveaways	RyersonU
exhibit ryerson paul cocker gallery showcases submissions toronto city hall competition ryersondas	RyersonU
student campus illuminate check weeks roadtoryerson events ryerson	RyersonU
exhibit ryerson paul cocker gallery showcases toronto city hall competition ryersondas	RyersonU
learn personal financial concepts tools manage money better ryerson rudebtfree	RyersonU
exhibit ryerson paul cocker gallery showcases ryersondas shaping canadian modernity	RyersonU
happy farmers market day visit gould st pm great eats fresh produce rueats ryerson golocal	RyersonU
rwileadership offering fulltime female student showing leadership	RyersonU
checked ruservicehub learn changed ryerson	RyersonU
celebrate entrepreneurship ryerson community summercompanyru closing reception aug info	RyersonU
ryerson sign learn best barrierfree routes travel campus ryersonedi roadtoryerson	RyersonU
president sheldon levy talks ryersons campus transformation thetorontosun	RyersonU
find ryscidean stem toys girls ryerson science	RyersonU
ryerson friends family ontsciencectr freemythbustersto admission saturday	RyersonU
bust myths ontsciencectr enjoy ryerson friends family dayaug	RyersonU
bigdata analytics longer optional businesses piece ryersons erik jensen globeandmail	RyersonU
produce grown green roof will todays farmers market gould st resist rueats	RyersonU
saturday ryerson friends family ontsciencectr freemythbustersto admission	RyersonU
icymi toronto teen attending ryerson launchzoneru basecamp builds heart alert device ailing mother	RyersonU
photography shapes view nuclear warfare energy ricgallery bigthink	RyersonU
servicehub opens today check hub dining area ruservicehub ryerson	RyersonU
review list upcoming power disruptions closures ryerson campus ensure	RyersonU
enrolling fall classes check academic advisement report ramss ryerson	RyersonU
ensure review list upcoming power disruptions closures campus	RyersonU
outstanding ryersonian nominate ryersonalumni achievement award deadline friday	RyersonU
athletics director drivanjoseph inspired parapanam athletes ryerson huffpostcanada	RyersonU
work happening distracted	SallySan_x
pissing laughing desiperkins snapchat follow	SallySan_x
hm yonge dundas eyesore bright	SallySan_x
bae going auto will chilling bed ice cream netflix toronto	SallySan_x
skype contact credits account making payments itunes	SallySan_x
bunny flat rabbit cute bunnies	SallySan_x
saturday spent evening watching netflix	SallySan_x
bed boy gaming	SallySan_x
dear cute guy ryerson resource centre hello	SallySan_x
cute guy ryerson resource centre	SallySan_x
mailonline people crazy	SallySan_x
leaving toronto friday sadtimes dontwanttogo willmissuk canada	SallySan_x
pack feeling lazy	SallySan_x
handed notice leaving weeks	SallySan_x
hahahahaha love pakalupapito	SallySan_x
recommend good hairdresser wirral haircut blonde newstyle bromborough	SallySan_x
working tonight bothered	SallySan_x
work tomorrow crawl bed cry	SallySan_x
asosstylist quick reply will asos restocking size	SallySan_x
gonna wake tomorrow feeling exhausted	SallySan_x
checking email minute helping	SallySan_x
spending swimsuit summer marahoffman festival	SallySan_x
dailystar attention money	SallySan_x
newlookfashion find top	SallySan_x
win rouge dior lipstick wardrobe	SallySan_x
going work week full timer start job	SallySan_x
hate waking work	SallySan_x
urghh lazy bed	SallySan_x
spending toooo money better spend savings	SallySan_x
swear body dairy products latte feel awful	SallySan_x
roast duck lunch	SallySan_x
ao washing machine	SallySan_x
omg walking dead killing favourite characters	SallySan_x
nb meet march start job time xx	SallySan_x
completely forgot valentines day saturday foreverlonely singlelife singlelifeproblems	SallySan_x
hongbinss yeah test products store	SallySan_x
time going soooooo sloooo	SallySan_x
nb you thinking weekends weekends	SallySan_x
toeatoncentre eaton centre	SallySan_x
applied college december heard starting worried	SallySan_x
vodafoneuk vodafoneicepick mememe	SallySan_x
hongbinss message whatsapp pretty concerned	SallySan_x
sleepy tooooooo hungry	SallySan_x
vodafoneuk love win great comp vodafoneicepick xx	SallySan_x
feel sick food	SallySan_x
win canon powershot sx hs camera worth sprinkleprizes sprinklecom	SallySan_x
woke wrong side bed	SallySan_x
complete assessment appointment recruitment consultant good start	SallySan_x
foundation months skin better	SallySan_x
craving midnight feast	SallySan_x
jeremitsme je fais bien merci	SallySan_x
apple pie custard favourite dessert	SallySan_x
vice palette debenhams stock makeup cosmetics eyeshadow	SallySan_x
cpwtweets offering exciting competition colourinvasion	SallySan_x
going oki dreaming	SallySan_x
random dream night met hot guy interested slip cos thought player	SallySan_x
debenhamsbeauty benefituk good	SallySan_x
nb start bet happy	SallySan_x
met big cuddly panda costco lol cuddlybear wholesale costco cheap	SallySan_x
davelackie annasui citylineca fabulous	SallySan_x
baby gravy lol americanhorrorstory	SallySan_x
davelackie love win owned bobbibrown products competition	SallySan_x
completed american horror story season	SallySan_x
nb yeah violin ball eyes	SallySan_x
nb omg start assessment stupid laptop	SallySan_x
nb kidding haha	SallySan_x
spent hours job application completed	SallySan_x
finally watch walking dead season	SallySan_x
nb yeah slacking	SallySan_x
debenhamsbeauty good hows debenhams beauty office	SallySan_x
hongbinss man aol ancient	SallySan_x
hongbinss long to uni loan bursary	SallySan_x
hongbinss dear internet unlimited korean videos watchingstreaming lol	SallySan_x
warm normal remember weather suppose feel october uk	SallySan_x
lazy drag bed	SallySan_x
huge craving cadburyuk chocolate fingers	SallySan_x
nb omg sold red velvet cake cafe worked toronto sweet	SallySan_x
nb wanna glasses lol	SallySan_x
haircut find good salon wirral	SallySan_x
going shopping birkenhead tomorrow excited word long wonder lot changes hmmm	SallySan_x
uk years toronto missing milk tea chatimecanada	SallySan_x
nb hahahah true	SallySan_x
narsfillmore narsissist omg lipstick collection	SallySan_x
thoughtcatalog read half freaked cantcontinue	SallySan_x
hongbinss good good excited	SallySan_x
bike ride completely destroyed	SallySan_x
ate cheese onion walkerscrisps cheese onion crisps canada	SallySan_x
spent hours pool toronto british summer tan	SallySan_x
things happen reason	SallySan_x
spiritspure sweet tart martini	SallySan_x
nb forgot skype	SallySan_x
nb green envy lol xx	SallySan_x
nb heard case surprise	SallySan_x
lethal cocktail glass tipsy	SallySan_x
nb swear eating lol	SallySan_x
digidreamsfest changed alerts hopefully will start receiving notifications help	SallySan_x
nb lingerie ready	SallySan_x
applying course online frustrating registered yday waiting email email reply gbcollege	SallySan_x
nb wrong levels lol	SallySan_x
digital dreams weeks	SallySan_x
closing shift tomorrow	SallySan_x
excited knifepartyinc ingrosso veldfest toronto rave edm festival	SallySan_x
nb told boati prefer slut lane definitely lot classier sluts hole	SallySan_x
nb hahhahahaahahahah rolling bed pissing laughing	SallySan_x
nb sack bad lol	SallySan_x
nb will thursday	SallySan_x
nb heard friend bailed weeks ago rude text apologized day	SallySan_x
nb bf violent prick friends broken family disappeared	SallySan_x
nb heard vanished thin air wonder	SallySan_x
nb text hate people	SallySan_x
gbcollege sad wanted apply course start september waiting certificates evaluated	SallySan_x
confused lifeim constantly wondering fate will life future	SallySan_x
shiftsi better nice pay cheque	SallySan_x
nb hahahahahahahah funny	SallySan_x
nb air options will skype week	SallySan_x
nb older exciting lol xx	SallySan_x
nb diet dropped dress size	SallySan_x
won roll rim	SallySan_x
nb drink nw goin toronto expensive cnt afford drink pics selfies sister lol	SallySan_x
laidback luke saturday guv toronto rave	SallySan_x
nb lol alive caught virus three weeks ago course	SallySan_x
por work place	SallySan_x
nb yeah lol	SallySan_x
watching robocop scotia bank theatre tonight	SallySan_x
nb ommmggggg milky bar buttons malteasers	SallySan_x
nb will defiantly november better plenty lingerie ready bed	SallySan_x
nb candy hows job hunting going	SallySan_x
jeremitsme calling putain	SallySan_x
nb parents argue grandparents constantly arguing silly things	SallySan_x
caesar salad breakfast pizza pizza lunch hate	SallySan_x
pair hunter boots feel invincible snow	SallySan_x
ticketmaster purchase tickets cnt pass recaptcha seriously tht shit simple	SallySan_x
nb good hear xxx fill xxx	SallySan_x
nb wanna weeks xx start saving xx	SallySan_x
guess coming toronto avicii	SallySan_x
nb watch movie	SallySan_x
expensive craving thai express	SallySan_x
nb omg posting today miracle hurt fingers netflix life	SallySan_x
join digidreamsfest canada day weekend toronto tickets digitaldreams	SallySan_x
wait martin garrix uniun toronto edm	SallySan_x
shift boo hoo	SallySan_x
nb lot expensive compared uk will check mac store	SallySan_x
nb watch tv series will	SallySan_x
nb cute walk	SallySan_x
happy year sending lots kisses canada	SallySan_x
stressful night work glad booked weekend	SallySan_x
nb santa urban decay naked palette santa	SallySan_x
start believing life suppose expected	SallySan_x
nb sounds hates reason	SallySan_x
asosheretohelp wrong dress size asos will refund postage cost send item canada	SallySan_x
ttchelps mins street car going increase prices tokens passes improve awful service	SallySan_x
laurenbeautyy asos parcel arrived yesterday felt kid christmas day	SallySan_x
virginmobilecan quick reply sim card problem virgin replaced	SallySan_x
nb you defiantly doctor	SallySan_x
hope asos dress arrives week	SallySan_x
shopping sucks toronto clothes shopping uk bad	SallySan_x
nb thts good cantonese poor lol	SallySan_x
nb brought good family clue attitude	SallySan_x
nb fluent language	SallySan_x
nb omg trust useless kid	SallySan_x
jeremitsme je suis tr bon merci beaucoup	SallySan_x
nb annoying cos hate wrking wkends wkends working wkends wkdays	SallySan_x
jessicasanx constantly sending random photos snapchat start uploading twitter joking	SallySan_x
love long conversations auntie linda	SallySan_x
yyifans leave early jess keen food	SallySan_x
love pay cheque	SallySan_x
ttc car today spadina streetcarto	SallySan_x
yyifans hows laptop piece	SallySan_x
entered chance win ga passes digidreamsfest tix onsale friday	SallySan_x
nasima set hours shifts place reason pay messed	SallySan_x
nasima public transport dare drive round glasses good	SallySan_x
start watching walking dead	SallySan_x
nasima thts wat uploaded photo dnt lancomes foundation thts favorite	SallySan_x
nasima apply jobs	SallySan_x
nasima forgiving biggest weakness	SallySan_x
people glamorize mental disorders	shawnaoh_
day chem cry	shawnaoh_
wait semester break figure life	shawnaoh_
havin fun time	shawnaoh_
negativity sucks suck	shawnaoh_
hey guys remember absolutely grinding winter ball tomorrow	shawnaoh_
cinders grossest bath bomb heyoooooo	shawnaoh_
wow sister talked louder phone night	shawnaoh_
buy alcohol university application fees pay	shawnaoh_
pumpkin spice pussy	shawnaoh_
shawnaoh diysignblog hears prayers	shawnaoh_
swallow solid food granted	shawnaoh_
probs bc concert high	shawnaoh_
dayswithdiane happy overwhelmed joy you deserve	shawnaoh_
thought control avoid watching oitnb provincials ha ha	shawnaoh_
gonna ride big jet planeeeeeeeeeeee	shawnaoh_
mom live vicariously	shawnaoh_
eating taquitos bath	shawnaoh_
safe flight grandma	shawnaoh_
bowers making hate math hate math	shawnaoh_
twerkling katyperry feel living teenage dream	shawnaoh_
tfs wasting data evil apples trivia crack	shawnaoh_
megan foster sarajangster period real winner	shawnaoh_
sarajangster tanner grew cuticle	shawnaoh_
jayleenaustria eres muy caliente	shawnaoh_
love life love friends	shawnaoh_
jieun anna spent fried chicken	shawnaoh_
oliviashannnon wait olive fucking	shawnaoh_
gardner tending gingerly hibiscus	shawnaoh_
oliviashannnon bitch fuck	shawnaoh_
allybrinn dare talk ebola joke stand ebola stan rat	shawnaoh_
skarlethp love skarleth	shawnaoh_
oliviashannnon olive ily	shawnaoh_
oliviashannnon fuck hard	shawnaoh_
christyclarkbc family move shit	shawnaoh_
fucking angel christinaardele	shawnaoh_
allybrinn oliviashannnon amy	shawnaoh_
august half hour	shawnaoh_
texts adrianna pics facebook	shawnaoh_
goodbye grade goodbye	shawnaoh_
gurshdeogan lol eyes kno	shawnaoh_
ticket lana tonight	shawnaoh_
jieun amigos pt	shawnaoh_
joanneoh hated start	shawnaoh_
sugar cookies plane ticket	shawnaoh_
uploading pictures care love vegas	shawnaoh_
lorijiang tweets speak	shawnaoh_
course coughing fit dead quiet room	shawnaoh_
rileyperri riley fuck hate	shawnaoh_
shoutout jieun bigfoot lmao	shawnaoh_
fattyofcakes math friend english mazucco planning fort media arts tilsley	shawnaoh_
jaeinjeong thought live day jaein jeong	shawnaoh_
favourite anna astren phase crimped hair plucked eyebrows aka half grade hbu	shawnaoh_
pasta fries problem	shawnaoh_
joanneoh kno rite bbg	shawnaoh_
watch catching fire	shawnaoh_
sry hang week plans	shawnaoh_
omg better wifi asap wtf sos live	shawnaoh_
shawna call wifiless friday	shawnaoh_
twerkling throwback club penguin year hardest time finding eachother god	shawnaoh_
jesus annas netflix account	shawnaoh_
living state dreaming	shawnaoh_
jaeinjeong yummy food poisoning cup tbh	shawnaoh_
lived london sos	shawnaoh_
you leaking direction album hashtag bc better	shawnaoh_
twerkling better ready dick	shawnaoh_
everytime scroll tweet twerkling gains chin	shawnaoh_
misses school chinese food thx dad	shawnaoh_
tbt slept saturdays	shawnaoh_
michael sos pls bae	shawnaoh_
spell analyze anal	shawnaoh_
swear half female population going cats	shawnaoh_
kaileyhbu tonights night abt deadline timeeeeeeeeeeeeeeoh	shawnaoh_
hombosexuals laughing lol olo	shawnaoh_
wow terrified fright night	shawnaoh_
day falling apart	shawnaoh_
montsedeveras gettin shit babe	shawnaoh_
volunteering start early	shawnaoh_
eggs eggs eggs eggs eggs	shawnaoh_
petition buy ms mccarger wardrobe	shawnaoh_
xmatthx dad henderson mall	shawnaoh_
hollaclare excuse excuse	shawnaoh_
auburn will rape kids	shawnaoh_
bc follow dirtyfanfiction	shawnaoh_
vancouver sosassbutt sos live	shawnaoh_
play evil apples iphone link iphone join	shawnaoh_
going emotional breakdown someday wait	shawnaoh_
praying bed ace science exam	shawnaoh_
amieisfierce omg door cinema club wanna listen ofc	shawnaoh_
bc love lots breakingthelaw oops	shawnaoh_
sos calum sos ashton sos luke sos michael sos birthday follow guys	shawnaoh_
turned coffee staining paper thx chaput rock	shawnaoh_
rileyperri big breasted italian	shawnaoh_
fianc plates eat food bc left fucking baby floor omg life	shawnaoh_
cinderella party dresss	shawnaoh_
laptop shuts shawnas sims family	shawnaoh_
aw good times bbgz sarajangster jennamaciver doubledazzle bachadam annaastren	shawnaoh_
bought family love jesus loves	shawnaoh_
ride bus lot pls text bc emergency	shawnaoh_
ios justcame omg sjakdklaksksks	shawnaoh_
sarajangster nice emoji	shawnaoh_
alexfranceband karleysquidward chaseyourwords god going hell	shawnaoh_
to bath body works pick pumpkin scented	shawnaoh_
aquarium solid hours tomorrow longgggg	shawnaoh_
calum sos monkey	shawnaoh_
round crying eyes notebook	shawnaoh_
fuck movie beautiful	shawnaoh_
montsedeveras kim jong il montsaaaa	shawnaoh_
luca won masterchef screaming joy omfg cry happy	shawnaoh_
guys pay entire thing	shawnaoh_
wanna inthetubwith sos sos live	shawnaoh_
frozennnnnnn sos live	shawnaoh_
watch marcusbutlertvs video	shawnaoh_
hombosexuals close needing loser	shawnaoh_
michael sos hii	shawnaoh_
twitter karley chrisyourwords live	shawnaoh_
luke sos ways	shawnaoh_
ashton sos football	shawnaoh_
amieisfierce obsession search fanfiction god	shawnaoh_
kaileyhbu aw cute boys	shawnaoh_
fucked advertisement youtube videos load	shawnaoh_
ironandwine flightless bird american mouth wow wow falling asleep delightful	shawnaoh_
ashton sos cute	shawnaoh_
luke sos wow love triangle exciting	shawnaoh_
michael sos throw cup water hate guys	shawnaoh_
rainy days busiest days aquarium basically life sucks	shawnaoh_
ugh orientation ugh	shawnaoh_
jennamaciver wat sayin rn	shawnaoh_
you aw bby ashton sos	shawnaoh_
jakeseed emojis asswipe	shawnaoh_
laughashton lucky asswipe wtf	shawnaoh_
basically wake pulling nighter	shawnaoh_
ashton sos doritos milkshake	shawnaoh_
hombosexuals nicks chest hair spoke reality	shawnaoh_
hombosexuals calums blood	shawnaoh_
luke sos lucas	shawnaoh_
casandralyons yaayyayayay wanna yooou	shawnaoh_
joannelovesjb bored jojo	shawnaoh_
georgiastathamx boys follow omg	shawnaoh_
will album osanswerme	shawnaoh_
hell luke wearing sunglasses inside attractive sosanswerme	shawnaoh_
vancouverr sos live	shawnaoh_
eye likes twitch public transportation	shawnaoh_
michael sos uh yeah	shawnaoh_
kaileyhbu tho fast food bit	shawnaoh_
stilababe perfect tho	shawnaoh_
nightowl fav doll xx	shawnaoh_
harrysfedoraaax dm calum follow love	shawnaoh_
calum sos armpits	shawnaoh_
sighs unattractive exhausting	shawnaoh_
unfollowing help lose virginity	shawnaoh_
hombosexuals homeless monkey ulcer	shawnaoh_
gettyleroakleyto idek tbh	shawnaoh_
sos green light aw	shawnaoh_
calum sos bbys	shawnaoh_
sos waiting follow tbh	shawnaoh_
jennamaciver waits impatiently thursday bc ice cream cake	shawnaoh_
bachadam liar sinner	shawnaoh_
luke sos follow spree butthole	shawnaoh_
hollaclare converting omg	shawnaoh_
peacelovehopey baconiam ofc	shawnaoh_
baconiam selfies hha	shawnaoh_
baconiam heehh plz	shawnaoh_
episodes breaking amish picture life	shawnaoh_
jennamaciver suck dick	shawnaoh_
hombosexuals rly garlic fries yumm	shawnaoh_
luke sos calum sos omg lucas	shawnaoh_
jelly factor timeeeeee	shawnaoh_
michael sos please	shawnaoh_
jaeinjeong kristinnitara volunteering	shawnaoh_
kristinnitara jaeinjeong lol	shawnaoh_
nightowl please god omg	shawnaoh_
kimberlyyfaye mariahhauser kims nudes wud nice yummi	shawnaoh_
hombosexuals shirt heehuehueh sos	shawnaoh_
calum sos vancouver	shawnaoh_
yogurt tube thing ejaculated	shawnaoh_
rileyperri going depressed	shawnaoh_
fucking complete happy omg	shawnaoh_
shat pants bc onedirection sos today	shawnaoh_
man waking work sounds fun	shawnaoh_
hollaclare kiss kiss	shawnaoh_
calum sos love meeeeeeeee	shawnaoh_
calum sos love	shawnaoh_
ashton sos bby	shawnaoh_
smells bacon house nomnomnomnomnonmonmonmonmonmnomnomomonmonmonmonmonnmnomnommnmnmmmnomnonmnnonmonmnonomnomnomno	shawnaoh_
kaileyhbu fan leaves	shawnaoh_
montsedeveras scotch egg consists hardboiled egg wrapped sausage meat coated bread crumbs baked wiki rly good	shawnaoh_
ripcorymonteith prayers family lea	shawnaoh_
amandaayall will love	shawnaoh_
annaastren yolo popo	shawnaoh_
jenna leaves bedroom whilst downstairs nice rude	shawnaoh_
hombosexuals twerkling lucas boy	shawnaoh_
fucking tired report cards shoot bye	shawnaoh_
briannejoe happy going leave shitikhada omg sucks	shawnaoh_
hav marvelous breadfish	shawnaoh_
casandralyons bring lovely	shawnaoh_
life disappear feel	shawnaoh_
long legs double time shave moisturize legs making short legged jesus	shawnaoh_
niallonnylon dollas holla wannsa	shawnaoh_
people suck alive hope happy paradise bee	shawnaoh_
to direction fall love jsut	shawnaoh_
write nipple book expecting laugh theodysseysucks	shawnaoh_
diamondzolanski reevaluate making fun eleanorjcalder	shawnaoh_
face it fault mine turn things	shawnaoh_
awkward minutes wowowowowoowowowowowowowowowowowowowowowowowow help breathe	shawnaoh_
malloryw ndr bye	shawnaoh_
anitakerster jakeseed kimberlyyfaye god jacob	shawnaoh_
niallonnylon mom naked scared	shawnaoh_
shit capitalizing letters	shawnaoh_
danielsahyounie will mother babies follow	shawnaoh_
wait saturday kmichaela jaeinjeong	shawnaoh_
excited kmichaela jaeinjeong	shawnaoh_
shark attack srsly	shawnaoh_
sofieyuuh tweet longer upload	shawnaoh_
lamlittlefoot omfg tweet ily	shawnaoh_
wow fun jakeseed	shawnaoh_
niallonnylon hahaha sweet will save hd camera	shawnaoh_
tgif omfg ugh	shawnaoh_
doubledazzle looked good night ugh fml	shawnaoh_
twerkling omg wtf fun ugh fml	shawnaoh_
danniprasad jennamaciver sexy	shawnaoh_
nasmaraj nickireigns nickiminaj shady	Simon_Pella
bernie hilary killing	Simon_Pella
steponme room feet	Simon_Pella
arshloc nehaaas lol	Simon_Pella
going retire snapchat stories basic	Simon_Pella
mac time in varsity area accident senior girls hockey team intimidating	Simon_Pella
artists tend graphite paper sad pencil	Simon_Pella
person effectively sing adele car adele	Simon_Pella
watch story snapchat hopefully will laugh	Simon_Pella
walked today realized warm anymoreits hot	Simon_Pella
wrote bomb introduction paragraph	Simon_Pella
people feel kill	Simon_Pella
justin beiber movement music videos diverse cast breath fresh air	Simon_Pella
voting nickiminaj amas artist year	Simon_Pella
kids nice manners	Simon_Pella
stress levels decreased immensely	Simon_Pella
norm savage tonight	Simon_Pella
nickiminaj kidding obvi	Simon_Pella
hillaryclinton crazy people disagree	Simon_Pella
nickiminaj freestyle week	Simon_Pella
sickness starting piss	Simon_Pella
emabiggestfansjustinbieber mtv ema vote	Simon_Pella
kazoo vine colonel pimple	Simon_Pella
nominatealessiacara mtvema alessiacara deserves	Simon_Pella
literally group country ryerson italy	Simon_Pella
love beaut cousin lilzonii	Simon_Pella
nah vine howieazy	Simon_Pella
ready easy vine lacey	Simon_Pella
video chilling virginia	Simon_Pella
summary party night vine chainz	Simon_Pella
homie roast vine nobeeetch	Simon_Pella
nickiminaj good playing role nic backtogether awesome video	Simon_Pella
wentworth soooo good	Simon_Pella
meek catching ls left centre	Simon_Pella
hope movie set watchman good read days	Simon_Pella
promise slay people heck vine charlotte summer	Simon_Pella
nicki molson canadian amphitheatre	Simon_Pella
bomb af friend negative vine everkelz	Simon_Pella
insecure mcdonalds order lady fuckin screams order ev vine kindasarahx	Simon_Pella
nickiminaj fanarmyfaceoff barbz	Simon_Pella
spelling game point himichaelk iridocyclitis vine nampaikid	Simon_Pella
face timing wrong ib donjose vine iamjayhayden	Simon_Pella
tommy vine dopeisland	Simon_Pella
hang dad vine valiumvillage	Simon_Pella
michelle nicki angles	Simon_Pella
eem brennenctaylor vine mrlegendarius	Simon_Pella
legitness vine krnxpaul	Simon_Pella
opinionated year vine laurengiraldo	Simon_Pella
party song asks money reality hits you vine jessivanessa	Simon_Pella
vrxox nickiminaj luck	Simon_Pella
guys girls wear makeup piques vine brittanyfurlan	Simon_Pella
mother fucker theresa vine csyd	Simon_Pella
srxo lives toronto lol	Simon_Pella
okayi guess vine valiumvillage	Simon_Pella
nehaaas boo help	Simon_Pella
song client vine thehairwhisper	Simon_Pella
bad start jason nash vine sunnymabrey	Simon_Pella
literally crying ripcasper vine laurenharrell	Simon_Pella
ghetto people horror films original dumbaf damnshame tb vine jayson roby	Simon_Pella
hold door daviddobrik vine lance	Simon_Pella
honestly loled nickiminaj	Simon_Pella
simonpella tidal exclusive excited summer wait nickiminaj	Simon_Pella
paid hard worked morning	Simon_Pella
you vine thegabbieshow	Simon_Pella
annoying fight facebook gender people	Simon_Pella
scary tattoo face murderer	Simon_Pella
love people open snap chats respond	Simon_Pella
currently freezing waiting	Simon_Pella
nickiminaj brings class matter	Simon_Pella
faces tetrahedron sides	Simon_Pella
aye early acceptance glendon	Simon_Pella
making fool nicki questions facebookbut till replies	Simon_Pella
famousclassy killa tomorrow rihanna town inspiration	Simon_Pella
nickiminaj seconds count telll	Simon_Pella
nickiminaj rrrrrrrrrrroman verse hunny	Simon_Pella
love fall stairs crack phone ipad screens	Simon_Pella
srxo yeah school find doe bae	Simon_Pella
nickiminaj wait christmas asked hard copy deluxe album target forgive broke itunes doe	Simon_Pella
love people credit things	Simon_Pella
srxo atthe door	Simon_Pella
girl outdo singing vine	Simon_Pella
nickiminaj canada feeling shade	Simon_Pella
nehaaas happy diwali	Simon_Pella
cashier money real wbriana kennedy vo pagekennedy vine	Simon_Pella
unaffected man inspired ryguy vineapp	Simon_Pella
cry video dropping pm	Simon_Pella
ready ep album cover	Simon_Pella
kids murder vineapp	Simon_Pella
fill word count school essay vineapp	Simon_Pella
anacondavideo bye nickiminaj	Simon_Pella
mrsdoubtfirewasmychildhood jumanji riprobinwilliams	Simon_Pella
grandmother finds eaten day remake haveyoueaten mrlegendarius vineapp	Simon_Pella
nickiminaj august favourite noloveremix	Simon_Pella
fun cali lilysumms	Simon_Pella
skinny people starving car max munchiemob vineapp	Simon_Pella
hey ma poolvinecovmtdawbwvqd	Simon_Pella
onerepublic changed life tonight bestconcertever	Simon_Pella
spell bmw bruh	Simon_Pella
street garagesale queens drive toronto	Simon_Pella
waking retainer sheets night concerning	Simon_Pella
school nickiminaj outfit pillsnpotions	Simon_Pella
asktyleranything excited nickiminaj album	Simon_Pella
ttc driver calling seconds bus	Simon_Pella
mrberkan bad analogies you english language understand mybiologylife	Simon_Pella
mizzonii greetingsalyssa wtf	Simon_Pella
scandalfinale kerrywashington omg nervous	Simon_Pella
beyonce number aprilfoolsday	Simon_Pella
left house three days save	Simon_Pella
srxo rot hell	Simon_Pella
jcpenney guys checks people good ellen	Simon_Pella
benadryldont loud ahsfx	Simon_Pella
original abercrombie catalogue lol	Simon_Pella
couple arguing ear care text min fml	Simon_Pella
amazing meeting guys	Simon_Pella
kinda early weekends	Simon_Pella
simonasantagato aallyxo lol alasandra	Simon_Pella
going die hill	Simon_Pella
laurdilorenzo love sorrynonna	Simon_Pella
nehasati facebook embarrassing thing	Simon_Pella
summer time sadnessss	Simon_Pella
woot woot baby	Simon_Pella
people calm guns georgia giant sign reads guns guns guns min gun	Simon_Pella
people cut shark fins throw water yeah hope ripped apart sharks	Simon_Pella
decided youtuber braces attemp fail yolo	Simon_Pella
stepped creakiest floor plank house year girls imweird imunique	Simon_Pella
selfie cuteness allowed vine seenive	Simon_Pella
simonasantagato call md skype	Simon_Pella
jamaicanlyricsyouliketoscream ere gyal whatagwan eh whey fi bowdown big chain evey respect queens mi nah	Simon_Pella
shushawnaa lilysumms will	Simon_Pella
nickiminaj confused talking	Simon_Pella
smiling baby bus sooo cute	Simon_Pella
butt police rear rear rear siren noise	Simon_Pella
bought unapologetic rihanna good	Simon_Pella
screw science study	Simon_Pella
nickiminaj will acting future xd	Simon_Pella
speeding highway catch ironman	Simon_Pella
despise ball hockey	Simon_Pella
paris hilton ymcmb kidding	Simon_Pella
forgot good avengers	Simon_Pella
play hockey game mapleleafs	Simon_Pella
pm massive amount luck coming lifesgood	Simon_Pella
kksa days reunion	Simon_Pella
fell stairs times today embarraassing	Simon_Pella
tasiasword nickiminaj loved	Simon_Pella
talklikeyourmom simon respond pick dads comin trouble	Simon_Pella
candiceai start describe amazing performance	Simon_Pella
thepussyasylum lol btw forget tripod white black clothes	Simon_Pella
shushawnaa year phone	Simon_Pella
commonwhitegrls borrow phone lilysumms	Simon_Pella
bitches love sosa	Simon_Pella
hate teacher teach test today	Simon_Pella
course daniel comments whatsnew	Simon_Pella
thought american idol glee time nickiminaj	Simon_Pella
nickiminaj will wig patricia freaksvideo	Simon_Pella
cp storm cm slush	Simon_Pella
woke heading paris stoked	Simon_Pella
big red bus london leicester square	Simon_Pella
nehasati weird tweet thing	Simon_Pella
asked sign language translation lifecomplete	Simon_Pella
simonpella silent hear thoughts deep meganraichelson	Simon_Pella
selmaalameri honestly angry	Simon_Pella
je mennuie ennuye	Simon_Pella
shushawnaa dishes princess tatiana	Simon_Pella
mrtinker listening ughh	Simon_Pella
ugghhhh daniel tired	Simon_Pella
great day today lovinglife	Simon_Pella
damn animals eugenia	Simon_Pella
nickiminaj wait tomo soexcited	Simon_Pella
profile picture temporary	Simon_Pella
best memory deaf camp	Simon_Pella
ears loud screams butistillloveyoumom	Simon_Pella
taughtme yolo die st	Simon_Pella
braces are christmas colours	Simon_Pella
nickiminaj legit amazing reminds original thereup	Simon_Pella
nehasati sort break bitch	Simon_Pella
shushawnaa hell beautiful jesuschrist	Simon_Pella
haha bitch rob ford	Simon_Pella
simonpella golfwanghoe subtweet twitter	Simon_Pella
guys class laughed word grade	Simon_Pella
ashley annex toronto streetstyle fashion styleblogger torontostyle canadian	styleofthesix
supastarjo honestly yah wanna yah	tanya_babbar
walk met game strong supastarjo	tanya_babbar
