rilaws quietwhisper talking guest felicity	AHKru
mandydennison oooh good	AHKru
shout guy announcing stops rod roddy style publictransit canada	AHKru
soo boys win	AHKru
kate bosworth pulling shoulders hard muster strength gorgeous dress goldenglobes	AHKru
astronomymag hemibenno check	AHKru
chaptersindigo delivers order store days ahead schedule yas	AHKru
good hear team telusmobility loving blackberry priv spread good word priv android canada	AHKru
congratulations aeryonlabs nattykate	AHKru
add priv list favourite letter blackberry android musthave	AHKru
nattykate pretty awesome	AHKru
gojaysgo jays fever	AHKru
day delay grtrow buses showing goodbye connections	AHKru
late post people kw gilt dtkitchener brunch damn good awesome quality	AHKru
happend qtip good	AHKru
finding going zizi pretty stellar wrap week	AHKru
life shialabeouf good robcantor	AHKru
yup book boardroom discuss gameofthrones finale coping skills coworkers tmr fuck hbo	AHKru
good night dave laughs lateshow daveletterman thanksdave cheers entire late crew	AHKru
bff sends link summer plans meghanrocca osheaga yassssss	AHKru
theborisdiaw spurs spurscoyote will blowing spurs fans maggieyepes	AHKru
bbmattk wow time warp loads memories good great pic	AHKru
eddykayla resident cat lady owning proudly	AHKru
eddykayla power thor	AHKru
ninja ninja tmnt hallowinning bbmattk	AHKru
mediaobsessed shutting shite	AHKru
shy tonight cool will fitspo cyling	AHKru
pffft day internationalcoffeeday coffee kaffee caf	AHKru
eddykayla living embodiment buddy mdear	AHKru
special kind champagne birthday today celebrating blackberry passport arrives wait	AHKru
eddykayla blood bath lolz	AHKru
holy humidity easy hustled fitness cyling	AHKru
wow azzurri knees che vergogna blame humidity congratulations uruguay races worldcup	AHKru
wow handing free kicks penalty shots caipirinhas opening match brazil brutal worldcup	AHKru
happy memorialday upper upd puremichigan	AHKru
love bowie love janelle monae love worldcup beautifulgame pepsi	AHKru
magic moments bella italianofilter	AHKru
nofilter una buona giornata	AHKru
meet rotunda dollar	AHKru
dear finaldraft creeping screen going brilliant totally unique overwhelmingly awesome	AHKru
editing best bbm instant msging video voice calling check check check	AHKru
starbuckscanada blonde day day	AHKru
vogue paired great videoint wsjp blackberry loveteamblackberry	AHKru
thankfully touque brunt hit canada	AHKru
love boys playlikeagirl gocanadago cdnolympicteam	AHKru
sooboys olympic broadcast today ted nolan coaching latvia teambradjacobs hustling curling semis	AHKru
brilliant audi ad nailed	AHKru
teslamay cdnolympicteam heart full canadian	AHKru
zapposservice lol will zappos service	AHKru
watching thegrammys red carpet headache makeitstop	AHKru
nights good fitness gohard	AHKru
emma thompson magic epic legendary good things goldenglobes	AHKru
leos jacket small buttoning second button goldenglobes	AHKru
enjoyed msging friend leaving caribbean won winter today bitterbitterly cold	AHKru
dior commercial jadore feat charlize marilyn grace airing lot pitchperfect	AHKru
long day travel destination	AHKru
time week will bella italia che meraviglioso	AHKru
dkny lol wellrounded lady beast	AHKru
serdatweets thecut nymag canadian wore canadiantuxedo uk day felt odd chic lol	AHKru
hey fashionistacom love check hyperlink bad gateway	AHKru
hey alizalicht cape lover to capes bring decide thegreatcapepurge	AHKru
skyscanner easy canada big sky country stunning vivid colours	AHKru
skype reinstating credit dormant year living overseas skype bbm indispensable	AHKru
love grassmarket district edinburgh excuse mobile fab it	AHKru
easy favourite karliekloss ridiculous red dress amazing iwant dkny great happy anniversary	AHKru
dkny caught talking loud blackberry hangs head shame lol time	AHKru
alexkinsella successful dialogue german client erfolg	AHKru
jnicoledub congratulations jenna	AHKru
bbmattk better wearing helmet protect melon	AHKru
hey canada helpful wireless wan pay sister koodofido better plans buy device	AHKru
ericalotman lol thought complete padre pio	AHKru
consumers going realize pared note ii	AHKru
worked tv oprah scenes porn gah familyday	AHKru
mediaobsessed bold wait	AHKru
church morning witness fitness	AHKru
markpgibson widest bean pole totally ridiculous	AHKru
wonder apples expensive iphone samsung making parts	AHKru
holiday thoughts tis season foodie will true foodie afraid indigestion eat	AHKru
good ladies read enjoy happy sunday	AHKru
vmochama good books	AHKru
elusivebalance oooh eating good olkw cafes	AHKru
kaymichl good luck winter west	AHKru
teslamay le sigh explanation needed	AHKru
watching wigan fullham sportsnet perfect saturday filled epl	AHKru
angelicize feeling today daniel johns beautiful man eyes lol	AHKru
elusivebalance totally agree amanda tweeps chaps ace	AHKru
singyshih wave fingers writing wellplaced finger point change	AHKru
road ontario beautiful today	AHKru
isragana ha love	AHKru
sound countless fans tossing livestrong bracelets swoosh	AHKru
mandydennison joel plaskett uber canadian anddddd mentions soo light moon	AHKru
magician call vajayme afternoon months making ready jayme	AHKru
singyshih youuuu best	AHKru
canada excellent steeze beastmode	AHKru
aliceluong safe assume aced	AHKru
teohalbert maggieyepes merciersara definitely albert wins loses lol	AHKru
conversations overheard hospitals range horrifying uplifting funny uncomfortable oversharing waiting rooms	AHKru
beast mode federer murray totally winning speech good ya kid	AHKru
great live border town celebrating canada day july festivities commence happy canada day	AHKru
nora ephron lost magic tonight	AHKru
philip lahm beauty	AHKru
happy fathers day dads special shoutout pop big	AHKru
call game devils game	AHKru
love passion unites promo sportchek euro	AHKru
maggieyepes luis will love discount buying set lol	AHKru
mediaobsessed lol will reserve cheap night movies paying full price riggo	AHKru
late party avengers rocked marvel jonfavreau joss whedon hammer	AHKru
pepsi twitter lock week long ad deal pretty simple concept find adage	AHKru
blackwater mad bloody tonight gameofthrones mustnt	AHKru
love love baby ripdonnasummer	AHKru
worse writing bible brain hurts	AHKru
tweeps head canadianprowrestling touring canada checkem u tix	AHKru
jbkruschack day album pretty awesome	AHKru
chirpy flyers fans tonight pens	AHKru
kinds awesome techvibes timmyrun	AHKru
deadline team effort twitter shoutout isragana martinkay merciersara	AHKru
afternoon tweeps hope friday going great special nattykate lady twitter gr tweets	AHKru
elusivebalance lots love amanda	AHKru
louisville kentucky game awesome second quarter	AHKru
disappointed mad men season premiere hbo madmen	AHKru
great birthday celebrations st pattys great friends xo	AHKru
sunny toronto moment mad global warming	AHKru
goodbye blackberrylandia kw twas great weekend xo to	AHKru
hey andersoncooper watched definitely interest stopkony	AHKru
martinkay ooh heard hungry martin lol	AHKru
ted prometheus coming excited excited genius campaign	AHKru
girl talk triple double	AHKru
kaymichl ooh good	AHKru
dears sault friendsfriday lop lops friends littlecitymusic play good pplgood drinksgreat music ittell tweeps	AHKru
angelicize lol longer	AHKru
adding phantogram listening list ugh love souping torch bbmmusic jams	AHKru
definitely soofood ugh	AHKru
loving living lake shore today april	AHKru
isragana martinkay vernetteeugene stimulating	AHKru
bbmattk soo love	AHKru
judge listening jump lilkim love oldie goodie feels lol	AHKru
angelicize gavinslate littlecitymusic disappointed missing tonight booooo	AHKru
hey rimcareers quick question will grad career expo jan mtcc week	AHKru
mariorocchetta dear friend mention scared cross bridge big brother watching creeeeepy	AHKru
bbm software updates folks fresh oven bbm bust	AHKru
rimcareers retweet great weekend	AHKru
ladies cheap minifacelift trick pretty minutes bare face lol	AHKru
kaymichl saultites major driving balls fail	AHKru
hoping loveliness nye starbucks order	AHKru
lupinis calabrese understand	AHKru
taggio gorgeous i uber canadian	AHKru
aliceluong definitely sad yay	AHKru
free redbull library	AHKru
task strive simplicity clarity interest repetition main point	AHKru
listening littledragon night ritualunion	AHKru
mediaobsessed feel very	AHKru
happiest birthday cuz dianamedaglia xoxo	AHKru
final feelin second wind kick	AHKru
citadel hell week	AHKru
streaming pens game homework lovin exhausted worth	AHKru
ginooooooooo goal loving malkin great goal	AHKru
wishing melissacugliett happy birthday pseudooldie club cugz	AHKru
love cut suit man capped handsome pocket square classic style	AHKru
martinlindstrom presentation today amazing insightful inspiring	AHKru
tonight calls neil young heartofgold	AHKru
blackberrynews great post kevin	AHKru
day sublime playing night	AHKru
pretty awesome enjoy halloweeners	AHKru
mariorocchetta friends rad	AHKru
early ladies running things sportsbiz melindatravis katrinakaye hmcharles check website	AHKru
mariorocchetta agreed friend	AHKru
coachkhamilton coach good	AHKru
shout blackberryhelp working restoring services going bbm withdrawl	AHKru
happy thanksgiving sault ppl family friends you kw fam havin	AHKru
hounds win tonight great job boys ohl	AHKru
capping night studying working assignments season premiere dexter	AHKru
good night hockey books habs hounds	AHKru
kaymichl sweet enjoy weekend babycakes	AHKru
great campaign blackberry love blackberry bbm superfan check	AHKru
geeze finally littlecitymusic	AHKru
ricob pic rick rhyme	AHKru
week complete freakin weekend cheers	AHKru
kaymichl knee slapper loln place	AHKru
christinekorda witty woman treasure witty beauty powergeorge meredith quotes beauty women love	AHKru
omg crazy night cbsbigbrother things carazay	AHKru
hope friends goderich tonight weathers supposed pretty bad	AHKru
awallenstein breaking breakingbad return amc reaches episode deal sony link coming	AHKru
mariorocchetta feel pain mario best worst thing lol	AHKru
wow wow wow fascinating murdoch newsoftheworld	AHKru
amandarubin everyones week start animated love story lol	AHKru
patmcgrathreal hey pat favourite high endlow makeup remover	AHKru
degrees celsius july typical canadian summer day tmr going figure lol	AHKru
merlottes goodnight trueblood hbo	AHKru
great day winnipeg jets nhl	AHKru
wishing canadian tweeps pleasant relaxed victoria day st long weekend kick summer enjoy	AHKru
amandarubin lol awesome relaxing enjoy	AHKru
lighter note enjoy sweet playbook ad vl qckqd feature playerembedded	AHKru
diane kruger killing jason wu metgala	AHKru
love dress mcqueen foe win royalwedding	AHKru
happy easter frohe ostern buona pasqua tutti hope chocolate filled day lots love	AHKru
cest bon plekanec beauty	AHKru
game time gohabsgo nhl	AHKru
black keys push wednesday afternoon sidenote playoffs tlspj mm	AHKru
amandarubin will to soo soo michigan styles cheap cocktails palace will change life	AHKru
summertime downnn good night tweeps	AHKru
bit presumptuous buy sandals week snow sault fail	AHKru
bell media logo time morning lookin good	AHKru
tweeps live profile shot smartphone users unite	AHKru
blackberry lovers unite good morning playbook will launch april woohoo	AHKru
exactly ad time nissan buy enjoy spots wondering robert downey jr vos nice touch	AHKru
watching bachelor finale stressful bad	AHKru
capital leave snow	AHKru
mediaobsessed ruined surprise montage obvious	AHKru
mediaobsessed good luck diana	AHKru
thisisfrances bachelor top model starts week excited judgment	AHKru
definitely black keys music kind day	AHKru
thisisfrances good bad	AHKru
mediaobsessed things tough yay	AHKru
john legend handsome face	AHKru
tweeps bbm monday hit green button bbactually call valentine guess habs win softie	AHKru
gem baby photo guess homage toddlers tiaras circa mid	AHKru
sooooo tonight boston ouff looked wednesday night reggies nhl mtl	AHKru
pens caps superbowl nfl descent sunday	AHKru
mariorocchetta mario valentines day cards killllllin lol	AHKru
loving pk subban flowers twirls	AHKru
celsius days love winter freezing canada	AHKru
ricob wise friend wise	AHKru
aaron sorkin great speech exquisite	AHKru
congrats erinkaplan wait kill teen vogue getem girl	AHKru
hey blackberry blackberryscene great playbook ads real thing goods	AHKru
second period canada blowing game worldjuniors	AHKru
perezhilton sell canada delicious kinder eggs favourite	AHKru
board nice goal foligno worldjuniors	AHKru
enjoyed st hbos penguinscapitals series night	AHKru
finally blackberry recognition blackberry rim	AHKru
tempted venture blackfriday will	AHKru
chicago wronghang tight sault	AHKru
thisisfrances patchouli stink outta high fidelity lmfao	AHKru
love digitalroyalty today queen elizabeth joins fbook conanobrien rejoins tv gotta feelin	AHKru
mediaobsessed year full head gear costumed head toe	AHKru
curtoneil find rate option website	AHKru
team amaroso slizzerd tonight lol sault shout bidus town	AHKru
degrees celsius cold snowing bought touque today working sorels spiffy coat	AHKru
appear mariorocchetta soo buzz weekends hunks yr event wout ticket	AHKru
curtoneil lol bigger hands jk	AHKru
fav expansion team pens original mtl playing enjoy game great hockey going mtl	AHKru
waffle thursdays alright	AHKru
suspect tim allen making bank voiceover work replaced james earl jones	AHKru
melissacugliett cents blackberry bbm	AHKru
today rock star love amandarubin	AHKru
hmmm choose nadal federer	AHKru
will picking october issue vanity fair	AHKru
dear rolling stone making today lot better madmen	AHKru
sportsbiz urself loving sport bogged biz sports takes magic	AHKru
prsarahevans red velvet petitfours	AHKru
amandarubin signs avail hold helping	AHKru
amandarubin hmmm reversal airport shittyness cuz fri awesome	AHKru
amandagravel evolving gotta fresh slammed competition	AHKru
mediaobsessed passthegin guys killing lmfao good luck diana	AHKru
canada guard bears guard dogs bears	AHKru
mandydennison best good brother	AHKru
katrinakaye listing sportzbiz	AHKru
amandarubin mandydennison team amazingness lol	AHKru
biking bruised tail bone good idea learned today	AHKru
better wednesday cute tanned sailors friend	AHKru
mariorocchetta lol guess going rotary fest weekend	AHKru
curtoneil checked tuscany weddings pics awesome pat good sir	AHKru
running shoes road track thinking reebok runtone thoughts	AHKru
missing elton john concert tonight thumbs	AHKru
fernando torres difference maker eurocup years ago esp riding bitter bus today worldcup	AHKru
bet lbjs decision ws jerseyshore shot miami millfist pumps hear snookies mascot heat	AHKru
curtoneil true story happy soccer bubble june stage underway forget	AHKru
curtoneil awesome grooveshark iceberg radio	AHKru
lukas favourite player firing ball ger	AHKru
williamryounce hey maple syrup belle ball canadanobody puts baby corneri prefer medium amber syrup	AHKru
great studio built soundproofed weekstudio coming alongteachers students excited learn	AHKru
win boys germany smelling fragrant worldcup ger	AHKru
mediaobsessed read thought talking lol	AHKru
john isner legend isner wimbledon	AHKru
mediaobsessed upchuck mouth thinking damn movie disturbed	AHKru
peach gary lineker football simple game men chase ball minutes the germans win penalties	AHKru
better feeling person starting career motivation	AHKru
germanys match today defined called beautiful game worldcup	AHKru
boy cheeky zawe elbme worldcup	AHKru
blackhawks magic game mad ave	AHKru
good bio read suggestions	AHKru
rip dennis hopper	AHKru
thisisfrances poutine heart hurt	AHKru
habs tisk tisk	AHKru
feels deleting things people today	AHKru
puck drops tonight watching folks	AHKru
wtf snow really	AHKru
mediaobsessed start petition shit banish tom lost	AHKru
elton john tickets	AHKru
commit heebie jeebies	AHKru
mediaobsessed room strung teens heart	AHKru
thisisfrances mega lol poor thing grumblies tumblies	AHKru
true blood promo	AHKru
people smash cream egg face despite love great cream egg morons whining	AHKru
waiting patiently secret diary finish watch	AHKru
man fucking crying omg	ATMXO_
el em ay ohhhhhhhh	ATMXO_
move forward happen	ATMXO_
she god shoe christian	ATMXO_
wow died la fitness today	ATMXO_
el em ay ohhhh	ATMXO_
quick react awkward situation work aries	ATMXO_
fuck wit bitch nigga	ATMXO_
michellesarah happy birthday michelle hope amazing live girly	ATMXO_
devikathakur omg whens bday girly lol best	ATMXO_
devikathakur spent hours pictures lost ten hidden	ATMXO_
twelveofspades baybeehmiina extremely fond instigating stating factsduuh	ATMXO_
devikathakur check app google photos dropbox mightve automatically backed	ATMXO_
experimenting variety methods reach satisfaction aries	ATMXO_
eaten pmhow hungry	ATMXO_
baby youre wanted	ATMXO_
devikathakur girl worst crowd youi walking lol	ATMXO_
loved missy elliots	ATMXO_
jeeez drugbarton map	ATMXO_
yooooooooooooooooooooooooooooo crying lmaoooooooooooooo	ATMXO_
regret choosing include people parts life bc image forever implanted memories	ATMXO_
employees attitude mistake	ATMXO_
gurit block instagramlmao	ATMXO_
ready set fire today order achiev aries	ATMXO_
stroke ingenuity solve problems spr aries	ATMXO_
intend catch unfinished business comple aries	ATMXO_
helenaaatee raycayray low key high key peep love bit	ATMXO_
incredibly flexible today tha aries	ATMXO_
baybeehmiina opsies gg loll	ATMXO_
manage careerrelated issues based aries	ATMXO_
carmennirvana freaky liking approval	ATMXO_
heart shattered omg	ATMXO_
engaging work struggle today su aries	ATMXO_
sister fuck phone fucking ass bed holy fuck ima kill	ATMXO_
wouldve time life goal age three	ATMXO_
singh king singh king singh kingggggg	ATMXO_
motivational purposes guess reps lose form	ATMXO_
cold shoulder nice aries	ATMXO_
writinggoing grocery store milk going grocery store milk fits	ATMXO_
favorite thing empty lol	ATMXO_
wow accuracy post hmm	ATMXO_
coward nigga fake	ATMXO_
mad frustrated life listening music help	ATMXO_
trailing pack usual style today aries	ATMXO_
fiazrahim ha will	ATMXO_
baybeehmiina ya ima sleep	ATMXO_
ameenakaay yourfavoritezoe died countless times watching	ATMXO_
rashaawn baybeehmiina allah	ATMXO_
excitement mounts consider angle creative pr aries	ATMXO_
fucking cheese rn	ATMXO_
will today imaginatio aries	ATMXO_
assumed track realize aries	ATMXO_
markpersaud size jeans size numbers size lol kno	ATMXO_
sairahassan funny lol wtf	ATMXO_
help raise issues rathe aries	ATMXO_
booty good wit confident ass	ATMXO_
anils yea man dude life	ATMXO_
ready dat dickk likeee carmennirvana	ATMXO_
fiji water carmennirvana	ATMXO_
selling year west indian female cook round roti cleans pretty baybeehmiina	ATMXO_
dianaasamlal dream beautiful face day motivates wake morning iknowumissme	ATMXO_
event unexpectedly triggered emotions aries	ATMXO_
idgaf imabitch sobeit votingforrealchange votingforbae trudeaumania	ATMXO_
twelveofspades no no inspiring honesty	ATMXO_
machu picchu building	ATMXO_
friend coworker appears answers today ev aries	ATMXO_
birdtwinkle mine weird	ATMXO_
wow man wow yall niggas childhood	ATMXO_
lilo stitch cry single time	ATMXO_
facing bottle problems	ATMXO_
good guys dmventures	dreamakerrealty
view penthousefuture dm spot trailer townhouses start dream yorkdale	dreamakerrealty
wealth funds invested real estate year realestate	dreamakerrealty
view floor dream residences yorkdalestyle floor left	dreamakerrealty
great conversation rosen harryroseninc development yorkdalestyle	dreamakerrealty
great day dream residences yorkdale	dreamakerrealty
condo rental vacancy rate toronto centre region lowest city buzzbuzzhomefundamentals	dreamakerrealty
good day pouring concretefull action week	dreamakerrealty
average price condo toronto sq ft hamilton sq ft buzzbuzzhome	dreamakerrealty
toronto prices jump april year ago singlefamily listings short supply financialpost	dreamakerrealty
dream maker rogers tv	dreamakerrealty
days sales percent solddrive percent nov cont	dreamakerrealty
moneyteam playlil wayne justin hahahahah	dreamakerrealty
live stock exchange ring todays trading day min	dreamakerrealty
great time partners raptors vip eventgreat meeting nigerian gm president ceo forward working	dreamakerrealty
loving canadian nigerian investment weekendcreating relationships will help secure investments nija	dreamakerrealty
intersting articlegen gen wealth stagnates forbes	dreamakerrealty
toronto real estate clubfor canadian wealth investors forum	dreamakerrealty
canadians allowed contribute cpp reignite culture savings urges cibc	dreamakerrealty
congrats hon jean augustine grenada flag ceremony independence city halldream maker realty official partner	dreamakerrealty
crawford adventist academyfor president obama inaugural celebrationdream bighistoric times	dreamakerrealty
busy month start yearhighly anticipated launchstay tuneyorkdale	dreamakerrealty
break real estate disney ice fam	dreamakerrealty
financialpost housing market strong canadian prices rise october good news	dreamakerrealty
site waterfrontdreammaker showcar scene worknplay dmr lovewhatyoudo	dreamakerrealty
kevinolearytv press today olearymortgages forward role big market	dreamakerrealty
time build relationships floor bmo party dmr realestateinvestments	dreamakerrealty
lifetimedev dream started wave decade ago liberty village happy dmr believed	dreamakerrealty
signing unit york love buying tridel units	dreamakerrealty
realnetcanada places grow torontostar ft realnetcanada great read	dreamakerrealty
set tridel head office york projecttv crew thomas dmrtvshow	dreamakerrealty
ready holiday seasoninvestors waiting best	dreamakerrealty
forward hearing author everyday real estate millionaires toronto real estate club great job marcel event	dreamakerrealty
dreammaker rogers tv pm talking real estatebusinesseducation dmr dfh view triplex queen st	dreamakerrealty
adds jobs jobs expected canada jobs jobs expected read economy hmmmm	dreamakerrealty
hmilborne great job hunter pleasure stage	dreamakerrealty
walk ryerson people lined waiting iphones best buy things love lineupforbricks	dreamakerrealty
starting potential africadreammaker corporation team ready	dreamakerrealty
interesting article lot sounds very close suggestions yr ago dmrteam	dreamakerrealty
real estate bestdmrtakeover mrto dreammaker	dreamakerrealty
liferetirement bitch plan learn dmrs yr net portfolio plan client	dreamakerrealty
demand condos rise wow surprise lol toronto star jumping info	dreamakerrealty
dmrdfh locally internationally push ends dream bigger reality bigger tomovement dmrdfh	dreamakerrealty
going traffic jude lol	dreamakerrealty
equity game joke bloombergtv knight capital group losses trading breakdown	dreamakerrealty
real estate stockscondo houses thinking wo perspective waste brain energy	dreamakerrealty
great media finally word fundamentals explain real estate market well	dreamakerrealty
queen west percent upto percent cashback free parkingrental program buy mann dreammakers	dreamakerrealty
couple hrs speech dreammaker launch unique vertical integration real estate market big buyn incentives	dreamakerrealty
pic thinggolfing forward golfing rbc wealth mgmt team	dreamakerrealty
fearrules market renters builders better incentives buy rates stay low longer investors win love	dreamakerrealty
wify lil princessglow dark mini golfing fathers day	dreamakerrealty
dmr canada college business technology graduation ceremony great speech hon jean augustine congrats graduating students	dreamakerrealty
financialpost secondmentor ernst young insight core successful entrepreneurs	dreamakerrealty
dreammaker high upper forrest hill project best work	dreamakerrealty
dreammakers motto invest play wellstill time access panam games units going fast	dreamakerrealty
hear coo dundee realty bus pamam games site tour sweeeeet	dreamakerrealty
drive dp movement stay tune building today tomorrows millionaires	dreamakerrealty
feels good to tonow ready dream project st phase panam games village love game	dreamakerrealty
great sunday serviceholy spiritand power lives speaking engagement dmrdfh empowerment tour	dreamakerrealty
question hey guys find asset buy pays market good upsilence lol	dreamakerrealty
clear mind golf course	dreamakerrealty
movementpresentation dreammakerscalled previp likeinvestors shocked	dreamakerrealty
mannn pad tavira bonita baythats talking	dreamakerrealty
long week flipping real estate building location dmr forward hrs rest miaoooo game wthe team	dreamakerrealty
hard choices great annexcasa loma project easier time picking lvs thin makn money projects	dreamakerrealty
buzzbuzzhome canadian population lives urban areas wow urbannation bildgta	dreamakerrealty
uploaded youtube video dream maker realty annual black voices conference	dreamakerrealty
day weekmore bricks pushed gta dreammaker team york radio interview dreammakerrealtyca big	dreamakerrealty
kcamadi bro mrk	dreamakerrealty
big upmdot acn chq lol follow system saidlol hmmm golf season started today	dreamakerrealty
nice parking presentation starthistory making parking project gtaand ofcourse dream team	dreamakerrealty
expensive crazy presents massive compare	dreamakerrealty
ready speech financial empowermentownershipanother long daythen mini investors group yorville project	dreamakerrealty
pack roomthe startyoung learn build wealth real estate	dreamakerrealty
walkerlaw thx will great speech	dreamakerrealty
watchin american greed cnbc princesson baby broker scamgzzzz people will money nutsall greed	dreamakerrealty
canada china steps include free trade deal historic investment deals huge movements	dreamakerrealty
dream makers live liberty village story brand foot ceilings msg interested	dreamakerrealty
tridel speaking bildgta event	dreamakerrealty
deals tablenow big negotiators win outa lot players dealswho will best dealhmmmmm	dreamakerrealty
walkerlaw excited honoured black history month posterparliament hill congrats deserve	dreamakerrealty
creflodollar faith practical expression confidence god word	dreamakerrealty
jca housetalking justice educationemploymentetc feel blessed change community	dreamakerrealty
great morning session	dreamakerrealty
powerful hr convothx lord	dreamakerrealty
great read donrcampbell year confusion concern consternation perfect environment sophisticated investor 	dreamakerrealty
great time church hear don moen perform high expectations	dreamakerrealty
canadabusiness real estate bubble news	dreamakerrealty
kardinalo good half time raptors gamesome good ol tracks	dreamakerrealty
reason dmr big projects mimico danforth read torontolife mag	dreamakerrealty
big ike dreamteam setting shiatsu massage teammuch needed lol tridel condo xmas party	dreamakerrealty
learn join category joining	dreamakerrealty
dreammakerworking dream pad mississauga story padby dreamteam members fab	dreamakerrealty
told going hard till xmas big meeting day big week couple meetings senators pastors builders hard	dreamakerrealty
game joke project buy listed price started units left	dreamakerrealty
real estate market slowing tridel building nice storeys love itmsg details gonna nuts	dreamakerrealty
slf thankswelcome dream team againanother great addition team	dreamakerrealty
tjmos thanksi greatest team	dreamakerrealty
weekend big week aheadnew project launch very close stay tune details	dreamakerrealty
toronto board trade award nightsold outshould good nightwe award	dreamakerrealty
wow speechkevin williams president ceo gm canadadeep	dreamakerrealty
fingers crossedpossible office lakeshore moving control area bf city sees valuelove game	dreamakerrealty
long daymorning interview rogers tvevening investors presentation campaign dreamfundwealth creation real estate	dreamakerrealty
good game overallhardest guys cutthis pick upplay hard team	dreamakerrealty
game timebout hit stagedreamfund	dreamakerrealty
toronto list best example growth opportunity city	dreamakerrealty
long daybut thx godgood job marcel closing fund increased holdings couple millionsdreamfund	dreamakerrealty
long week donetiff launchlets	dreamakerrealty
promisednew development projectrrsp eligibleland security prime locationhigh returns msg isaacdreammakerrealtyca	dreamakerrealty
ready head national basketball league canada st draft rogers centre	dreamakerrealty
ufsc toronto mentoring session dream big route generational wealth with isaac olowolafe jr president ceo	dreamakerrealty
best start morning golfing sandy lane golf coursebarbados	dreamakerrealty
move levelthe big players test usdream team waiting time hard	dreamakerrealty
dream fund manager one meeting president largest institution canada management talk dream fund	dreamakerrealty
excellent meeting giftsscholarship director major universitydreamfund green light stay tune large university fund	dreamakerrealty
good ol restingjust time long weekwelcome team korea	dreamakerrealty
best residential commercial opportunities dreamfund big time investors msg action large land development deal asap	dreamakerrealty
closer closerpple starting arguegzzzz money	dreamakerrealty
big investment launch saturday prime real estate msg info	dreamakerrealty
live cagp acpdp conference	dreamakerrealty
awudrick journodale governor general law door woman represents	MacSweeneyG
gavmac ottawacitizen paddynotpatty	MacSweeneyG
rickanderson channel news sense trump how ppl follow	MacSweeneyG
nspector fail fulfill civic duty gripe choose sit hands	MacSweeneyG
laurapayton teach cat tricks	MacSweeneyG
robfordmancs ldobsonhughes philosopher leave social scientists interesting	MacSweeneyG
graciestyle represented half confederation dief dividing stretch	MacSweeneyG
graciestyle elevate argument national unity serves purpose finding solution	MacSweeneyG
stuartinthecage gavmac paoconnell laurapayton cmaconthehill heads life good	MacSweeneyG
stefcoinc emmmacfarlane laurentianu interesting idea students sign contract	MacSweeneyG
insurrection declaration war philosophically	MacSweeneyG
sad day music lovers	MacSweeneyG
cmaconthehill stefcoinc nacci interesting description neighbourhood	MacSweeneyG
msbriggshdsb torontostar globeandmail tolerate positions agree tolerate find vile bc rec speech	MacSweeneyG
perreaux fantastic meat experience	MacSweeneyG
cbcr morning yep sing	MacSweeneyG
free letter word	MacSweeneyG
lack science tells good bad efficacy claims highly suspect	MacSweeneyG
suspect will trend volkswagen outsold rig emissions	MacSweeneyG
grown threats target soft targets parisstyle	MacSweeneyG
mlinstitute tashakheiriddin ian greene topic	MacSweeneyG
joshuahind terryglavin markbourrie mattgurney rowancaister	MacSweeneyG
mattgurney rowancaister terryglavin joshuahind state attacks french duty respond duty french	MacSweeneyG
illinoisrider vague freshness quality safety risk safety risk sick	MacSweeneyG
illinoisrider man tweet delete fast	MacSweeneyG
illinoisrider stefcoinc trolling carlsonlabs goedomega	MacSweeneyG
stefcoinc illinoisrider study accepted peer review chemist will submitting paper peer review	MacSweeneyG
mood left office vilified security concerns	MacSweeneyG
decision pmharper power infere elxn jkenney	MacSweeneyG
wow more father	MacSweeneyG
spartanvtyranny thomashall worlds conclusions theory justice	MacSweeneyG
talking bc situation dealt ohsheri mattgurney russilwvong fullcomment	MacSweeneyG
mattgurney ohsheri russilwvong fullcomment safe passage migrants	MacSweeneyG
rosiebarton iancapstick tashakheiriddin depending result sooner	MacSweeneyG
hey tompowercbc listen rock swings paul anka great underthecovers counts cancon	MacSweeneyG
richmondhillndp election hold seats statement vacuous seat	MacSweeneyG
dimocksusan sharing onfb emmmacfarlane cmaconthehill laurapayton find interest	MacSweeneyG
nspector academic knowledge area ban pass oakes test tomhawthorn dgardner	MacSweeneyG
bonkwazi collective talking cut individual rights robsilver	MacSweeneyG
century history course online read book	MacSweeneyG
nspector hosting debate excluding party awudrick charitable status heart argument	MacSweeneyG
paoconnell gavmac cmaconthehill stuartinthecage true love	MacSweeneyG
felt pain cat	MacSweeneyG
jandrewpotter libs serious damage cons appealed blue liberal side party elxn	MacSweeneyG
depressing concerning elnx change voting structure	MacSweeneyG
nspector course billion aid	MacSweeneyG
nspector statement straight binary option question pm motivated	MacSweeneyG
wait thomasmulcair wrote piece sun	MacSweeneyG
stephentaylor unduly influence third party audit independent seat government job justice system	MacSweeneyG
mdentandt residency norm number pms precedence	MacSweeneyG
laurapayton celiacs nightmare	MacSweeneyG
robsilver minutes good cpc will attack ad jt	MacSweeneyG
ian greene senate reform love hear thoughts craigscottndp pierrepoilievre honstephanedion	MacSweeneyG
definitely picture canadian federalism	MacSweeneyG
cents cmaconthehill stuartinthecage stefcoinc gavmac laurapayton	MacSweeneyG
bruceanderson katewheeling initiatives introduced metropolis recycling programs aiding cash strapped cities	MacSweeneyG
nationalpost changing issue issue arises reasons changing colours seismic shift better good reasons	MacSweeneyG
jandrewpotter scottreid ottawacitizen question portion cons vote jump libs avoid pm mulcair	MacSweeneyG
markdjarvis pmlagasse disciplines lend public engagement	MacSweeneyG
fsorbara jkoblovsky list civil libertarian surely voting cpchq ndphq	MacSweeneyG
geddes journodale aaronwherry term limits problem scc senate reference strong note tenure required	MacSweeneyG
kinsellawarren word duffy	MacSweeneyG
realdarrencohen nhl season bit life	MacSweeneyG
actiongeologist leftardhockyguy harmful offensive	MacSweeneyG
actiongeologist leftardhockyguy accountable	MacSweeneyG
kids fun playing long weekend bath water swamp waterman dirty fun	MacSweeneyG
peterkimglobal globalnewsto park	MacSweeneyG
stefcoinc uberfacts breasts strike unionized couple years ago sessions	MacSweeneyG
liberalparty justintrudeau typo	MacSweeneyG
brynnbeard department thinking critically	MacSweeneyG
hollywood sins vans warped tour battle bands follow click warpedtour hollywoodsins sinners	MacSweeneyG
great read nato articlev upheld	MacSweeneyG
mrsinisterlefty laurapayton feeling left claiming claiming left win	MacSweeneyG
mrsinisterlefty laurapayton constant presence regularity suffice	MacSweeneyG
globalnewsto buy beer beerstoreboycott blackmailing customers monopoly disgusting	MacSweeneyG
cbcthehouse evansolomoncbc bobrae typo read	MacSweeneyG
chastonb fareestweetable ctvmercedes sending message engagement choosing vote bc choice apathy	MacSweeneyG
fee increase force baseball club field	MacSweeneyG
shauntanakays puzzlement mandatory voting will change institutionalsystemicissue	MacSweeneyG
ethicsblogger help connect head wall	MacSweeneyG
eekfarms councillor glad twitter forward tweets	MacSweeneyG
natnewswatch ivisonj acoyne tie hands opponents	MacSweeneyG
cmaconthehill three kids forty years making	MacSweeneyG
justintrudeau special envoy staffan de mistura warned faces spectre srebrenica	MacSweeneyG
walked flooded office morning frosh blocked urinals doori hate dispose books gifted	MacSweeneyG
cmaconthehill laurapayton excuses	MacSweeneyG
stephen harper changes version events phone call beverley mclachlin torontostar	MacSweeneyG
medfoods interest pivotalthr announces patent omega medicalfood vascazen obesity diabetes cardiovascular	MacSweeneyG
baby born close	MacSweeneyG
cmaconthehill suck buttercup	MacSweeneyG
drake builds pc	MattSkiing
realized played good rpg terribly wrong	MattSkiing
iron maidens greatest thing	MattSkiing
nutella treats coming tim hortons ctv news	MattSkiing
win lose game	MattSkiing
watch eslone katowice check raffle awesome gaming gear	MattSkiing
carrying drum key	MattSkiing
sunshinevillage dive considered slackcountry	MattSkiing
vinnie colaiuta attack lb pizza youtube jesus christopher awesome	MattSkiing
youtubeanderzel contest anderz	MattSkiing
wonder elder scrolls will thing	MattSkiing
song linkin park feat hamilton	MattSkiing
sierratheresar antijokeapple bad	MattSkiing
going ski school today	MattSkiing
people don country hope listening eric church favourite	MattSkiing
cs opening weapon cases giveaway youtube	MattSkiing
newschoolers turns year mtstlouis	MattSkiing
lol threw leafs sweater ice	MattSkiing
pumped start hockey week	MattSkiing
lol active things playing computer	MattSkiing
twitter account character popular movie people time hands	MattSkiing
lol android emoji works	MattSkiing
bike stolen mcdonalds thomas glen erin pm today text asap white green nakamura	MattSkiing
metallica live die	MattSkiing
danielcalabres lol classic	MattSkiing
poorboyzlive chads gap	MattSkiing
man sunshinevillage weekend skiing	MattSkiing
house invaded ants	MattSkiing
madelncanada ryanjamieson error server find requested installing program	MattSkiing
twitcon mt st anne	MattSkiing
raptors game sooooo sick bad lost	MattSkiing
follow jaggonzaga stay updated happenings school community	MattSkiing
robotics exam will question worth marks	MattSkiing
major leak fireman	MattSkiing
cottage perfect pond hockey skates	MattSkiing
skied course intense	MattSkiing
djing couch plugdj playing rush red barchetta will admin	MattSkiing
ohmzapp omg calm	MattSkiing
guy apply cadbury global control manager	MattSkiing
lol letter parents campin august	MattSkiing
etholp etho mindcrack smp episode quartz tragedy youtube tragic	MattSkiing
nickb file sharing people network	MattSkiing
vintagebeeflp youtube haha watching gennys stream laughing hard pigstotheslaughter	MattSkiing
seanpettit day life high school	MattSkiing
vanedeluca eds apple releases beta registered ios developers torrent websites	MattSkiing
amazon shipped weekends	MattSkiing
lol tweeted ipad ios simulator computer app testing	MattSkiing
thinbodycutskin stay strong hope	MattSkiing
lol love spread eagles	MattSkiing
awesome family day	MattSkiing
making science notes	MattSkiing
phineas ferb ohh perry	MattSkiing
check side bury face snow	MattSkiing
hate filling paperwork	MattSkiing
omg destonys child reuniont ya cares	MattSkiing
ya happened today school	MattSkiing
lol cute lil bugger	MattSkiing
company previous tweet	MattSkiing
watching hard rock calling bell fibe tv hifi hardrockcalling	MattSkiing
yum christmas leftovers	MattSkiing
awesome christmas luv family	MattSkiing
man hope better	MattSkiing
finally stopped mattskiing mattskiin booyah	MattSkiing
concert soooooo awesome	MattSkiing
laurenxo skiing chirstmas break sameeeee	MattSkiing
thatarabdev add contacts add email apple	MattSkiing
guys sign dis petition internet free freeandopen	MattSkiing
red civies day works	MattSkiing
yeeeessss argos grey cup champs	MattSkiing
skierproblems going vt ski	MattSkiing
tired finished hockey	MattSkiing
songsonshuffle rock ages	MattSkiing
gforce today seconds stillcounts	MattSkiing
lol modern family funny awesomeshow	MattSkiing
minecraft pocket edition update	MattSkiing
people talk lot	MattSkiing
braveselric kevingetem ofcoodarwg leaglized colorado washingto state	MattSkiing
followers live canada kazakhstan create map	MattSkiing
samsung galaxy tab ipod family pin connectors zune pin connector	MattSkiing
hope lots money	MattSkiing
thundromon gonna meet libary	MattSkiing
tomyfutureson playstation turn iphone going skiing going	MattSkiing
watching ojhl game	MattSkiing
awkward moment real absurd trend find magicalpowercupcakes	MattSkiing
wanna watch number	MattSkiing
wear halloween costumes zaga	MattSkiing
europe eat morning continental breakfast	MattSkiing
gonna hard morning	MattSkiing
coke cold tho	MattSkiing
vote man killed osamagreat job bruce	MattSkiing
stoked sundays concert	MattSkiing
huge truck filled propane tanks rite	MattSkiing
holyyy crap debate heated	MattSkiing
braveselric ya jelly	MattSkiing
yikes degrees redbullstratos	MattSkiing
tired tweet characters	MattSkiing
canadas wonderland street view	MattSkiing
lol meeting hairy club members	MattSkiing
thatarabdev week till cast nice	MattSkiing
ommmmmggggg bad call	MattSkiing
watching sportscentre school	MattSkiing
ipad mini will announced oct	MattSkiing
going soooooooo fast	MattSkiing
watch likes hunger games	MattSkiing
rush strugers sick	MattSkiing
tweeting live gym	MattSkiing
vimanala necklace questions	MattSkiing
best time wear striped sweater	MattSkiing
omgfacts top video game picture facts favorite mind blown truestory	MattSkiing
today kinda sucked	MattSkiing
finished geo assignment geo assignment	MattSkiing
myfavouritelyrics good easy good free	MattSkiing
wow day screwed homework	MattSkiing
wierd bumpy road	MattSkiing
weeks nice days	MattSkiing
wtf facebook contacts mixed contacts phone	MattSkiing
timmies frozen lemonade nasty fully melted	MattSkiing
stoked nice bike ride tommorow	MattSkiing
phone messed service pretty coverage canada wifi	MattSkiing
lol funny vid	MattSkiing
watched movie called desecnet	MattSkiing
day life professional drum technician drum magazine drummagrocks	MattSkiing
wizard late frodo baggins early arrives precisely gandalf	MattSkiing
awesome happy canada day weekend fbi il zscfeature youtube	MattSkiing
martinfleury mattskiin happened nite	MattSkiing
best minuets school dance history	MattSkiing
ahh missed tweet rabbits north america	MattSkiing
going play tennis	MattSkiing
yeeah grad mass	MattSkiing
mattskiin noooo iam	MattSkiing
mikedski sport crazier tricks bmx proof omggggggg watch everyon	MattSkiing
watched spider man	MattSkiing
happy bday sierratheresa leafs better	MattSkiing
happy bday oddfuturetime	MattSkiing
spider man soo buss	MattSkiing
snake battery dying	MattSkiing
oddfuturetime mine pwnd	MattSkiing
ommann best weekend	MattSkiing
friends awkward awesome times	MattSkiing
love cartoon telephone voices	MattSkiing
yee caught disemering murder	MattSkiing
view trends trending	MattSkiing
fangirling things sick	MattSkiing
hargen flargen dargen	MattSkiing
thing takes seconds load exit	MattSkiing
ohmzapp mattskiin mentionsomeoneyoulove mattskiin smells cow poo mentionsomeoneyoulovethemostthatsmellslikecowpoo	MattSkiing
toilet making wierd noises	MattSkiing
espnnhl kings devils	MattSkiing
public transit bus time nervous excited	MattSkiing
replacemovietitleswithbacon iron bacon	MattSkiing
cut finger pop	MattSkiing
stanley cup la kings jersey devils	MattSkiing
zuballl night match	MattSkiing
gotta move fast gotta move fast	MattSkiing
soccerswag passed tweets twiitrer longer	MattSkiing
woah twitters stuff	MattSkiing
yeaaa friday long weekend	MattSkiing
ommmmannn ceamiscle blue	MattSkiing
lukemartin panic attackdream theatre	MattSkiing
ummmm agt ummmmm	MattSkiing
lol phetunning told friends street puns laughing crazy	MattSkiing
yesssss guna nice	MattSkiing
good day planned	MattSkiing
ow sliced finger cutting fruit	MattSkiing
white txt tweeting reply	MattSkiing
woow downloaded app installed apps phone	MattSkiing
mikedski sunset booger	MattSkiing
phetunning eat bowl bran flakes hours coolbeands	MattSkiing
bobbybrown hopefully will favourite avenger	MattSkiing
wo better wifi connection house living room smh	MattSkiing
daviddevids hey pleae watch vids views	MattSkiing
tweets compared oddfuturetime annadeguzman kenlondon sierratheresa	MattSkiing
gts the day	MattSkiing
phetunning fegde film	MattSkiing
hope obsess weeks finals haha studentlife	Nounnno
tweet bismillah firsttweetforeverything	Nounnno
today simple terms	RowanMMolloy
troyesivan toronto dates	RowanMMolloy
jamming sick music greysonchance	RowanMMolloy
kiss work lit remixes help djclymaxxx	RowanMMolloy
troyesivan toronto dates pls	RowanMMolloy
tronnorfravan trust bows	RowanMMolloy
troyesivan kinda dates	RowanMMolloy
troyesivan inside sick	RowanMMolloy
evanedinger feel man	RowanMMolloy
troyesivan follow canadians	RowanMMolloy
loving troyesivan youthvideo	RowanMMolloy
nice work troyesivan youthvideo	RowanMMolloy
wow youthvideo troyesivan	RowanMMolloy
holyshitsivan super excited friday forever	RowanMMolloy
troyesivan blue moon	RowanMMolloy
vikkstar days die	RowanMMolloy
corradocoia screening toronto	RowanMMolloy
ashleymardell best decision	RowanMMolloy
troyesivan troye wtf	RowanMMolloy
troyesivan blueneighbourhood trending king	RowanMMolloy
nanowordsprints hufflepuff won	RowanMMolloy
toronto blueneighbourhood tickets sold	RowanMMolloy
guess write today	RowanMMolloy
day fully caught nanowrimo	RowanMMolloy
writing easy today hopefully stays nanowrimo	RowanMMolloy
uninspired writing today day working hard tomorrow nanowrimo	RowanMMolloy
nanowordsprints great awful usual week	RowanMMolloy
novel changed direction better delete nanowrimo	RowanMMolloy
donated doubleupday nanowrimo saved writing ways	RowanMMolloy
day today strong extra sleep change tomorrow day nanowrimo	RowanMMolloy
kimkali nanowordsprints close	RowanMMolloy
dealynn nanowordsprints congrats	RowanMMolloy
tarp moving repeat tarp moving min game start cometogether	RowanMMolloy
pass time nanowrimo starts going nanoprep	RowanMMolloy
baseball hit won series bluejays caf	RowanMMolloy
mutantcanuck read short books middle ages help lot writing	RowanMMolloy
mutantcanuck fantastic worth tickets free helped	RowanMMolloy
calendar calendar nanowrimo	RowanMMolloy
year plan write tonano time excited nervous nanoprep	RowanMMolloy
brighthappyplnr year likes stray nanoprep	RowanMMolloy
embeetree write fun parts fill gaps entertaining scenes easier write nanoprep	RowanMMolloy
friend mine beautiful art style draws characters nanoprep	RowanMMolloy
nanowrimo hamilton person nanoprep	RowanMMolloy
jasminedawn hello nanoprep	RowanMMolloy
kaciecruise nanowrimo year	RowanMMolloy
year nanoprep season tips writing high school nanorebel planner	RowanMMolloy
corradocoia talk positivenegative comments vlog	RowanMMolloy
decided officially start editing btsov novel years ago printed createspace nanowrimo	RowanMMolloy
feel woke tired	RowanMMolloy
simple pleasures pencil paperwriting poetry	RowanMMolloy
going imitation game excited	RowanMMolloy
best thing room charlestrippy love ctfxc charlestrippy	RowanMMolloy
perk hankgreen realkgreen movie commentary soexcited p	RowanMMolloy
perk hankgreen jobogro nerdfighters art p	RowanMMolloy
winners goodies love nanowrimo	RowanMMolloy
corradocoia healthy corrado better moved hours	RowanMMolloy
kristanbremner don cherry jellybeantie canidropshroomsinyourcloset kaciecruise	RowanMMolloy
nanowrimo coffee left	RowanMMolloy
finally sitting writing time day nanowrimo	RowanMMolloy
late night writing nanowrimo writer	RowanMMolloy
unrelated bothers lot title better start working nanowrimoproblems	RowanMMolloy
jessann whoo hoo	RowanMMolloy
lovelockeprince raining umbrella help	RowanMMolloy
kendramase written week finally bouncing hour day short time helps	RowanMMolloy
wanted to tonight feel pretty terrible tomorrow	RowanMMolloy
johngreen hankgreen swusug realkgreen john	RowanMMolloy
plot bunny month nanowrimo nanoproblems	RowanMMolloy
honestly novel going writing nanowrimo	RowanMMolloy
early celebratory cake alextwestlake	RowanMMolloy
frinightwrites anginicole hello	RowanMMolloy
totally hit total today track nanowrimo amwriting nanowrimo	RowanMMolloy
tbt mutt grew fast	RowanMMolloy
booktrack interested tomorrows playlist will written site hmm nanowrimo	RowanMMolloy
frinightwrites big writeclub statsguy	RowanMMolloy
hitting dream today nanowrimo	RowanMMolloy
todays goal currently nanowrimo	RowanMMolloy
cantrelljason nanogeekette twitter supposed min	RowanMMolloy
nanowordsprints jumped halfway current total	RowanMMolloy
days nanowrimo nanoprep	RowanMMolloy
celiamcmahon find rowanmolloy	RowanMMolloy
love years calendar nanoprep iamcrazyexcited nanowrimo	RowanMMolloy
charles wren milo todd dr munro character names nanoprep	RowanMMolloy
phone charlestrippy tweeted iphone wrong	RowanMMolloy
nanowrimo sushimustwrite thebratface extra day write thanksgiving november canadianproblems	RowanMMolloy
nofilter photo canon rebel xt	RowanMMolloy
cbc sponsoring event phone cases adorable	RowanMMolloy
rhettmc linklamont legitimately nicest people honestly care mythical beasts bufferfestival	RowanMMolloy
rhettandlink landed soft batch pillows rlstory	RowanMMolloy
pmshinexxx feels great years sweet feeling	RowanMMolloy
corradocoia coreyvidal hydration rest tea	RowanMMolloy
dawnmariaaz nope years win whynano nanorebel	RowanMMolloy
nanowrimo talk forum completely fail	RowanMMolloy
mazerunnermovie mazerunner heart attacks fun	RowanMMolloy
threewordsshewantstohear brought pizza alextwestlake	RowanMMolloy
charlestrippy happybirthdaycharles dragon	RowanMMolloy
glasses glory sarad corradocoia alsicebucketchallenge	RowanMMolloy
queenofheii rhettandlink email bufferfestival tweet corradocoia	RowanMMolloy
saskiavanell loved vlogs excited appeh team third time buffer	RowanMMolloy
ugh hours hour nap consciousness nyc	RowanMMolloy
nanowordsprints nope distracted	RowanMMolloy
nanowordsprints will better	RowanMMolloy
great start campnanowrimo amwriting	RowanMMolloy
day filled drawings art drawing chill	RowanMMolloy
drawing drawing drawing art drawing	RowanMMolloy
stayin alive stayin alive habs lead becauseitsthecup	RowanMMolloy
pacioretty habs becauseitsthecup	RowanMMolloy
lakings coming will	RowanMMolloy
nanowordsprints murder time best sentence figure going reanimate alright	RowanMMolloy
nanogeekette book store thinking	RowanMMolloy
nanowordsprints silliest song planet kristenecollins fight scene brewing	RowanMMolloy
dog learn kicking sleep ow	RowanMMolloy
currently listening tracks playlist whilst writing campnanowrimo motivation	RowanMMolloy
nanowordsprints year write project july	RowanMMolloy
biggest thing noticed tsbnick classes tech person icantfixyourcomputer letmework	RowanMMolloy
read paper towns realjohngreen reading	RowanMMolloy
woke sleeping dog gardiner tmltalk	RowanMMolloy
frinightwrites danceturnipparty favourite hashtag	RowanMMolloy
frinightwrites months ready write writeclub projecteastman	RowanMMolloy
vocal class daft punks doin refuses leave head	RowanMMolloy
live students telling calm lighten expect teachers bit kind anxietyproblems	RowanMMolloy
guess kolbetweets putting student week sweet	RowanMMolloy
gusrachels canadian dollars	RowanMMolloy
baileyrufer current count	RowanMMolloy
beautiful bozak goleafsgo	RowanMMolloy
panic attack ottawa grade anxiety bellletstalk	RowanMMolloy
bellletstalk beautiful bellletstalk	RowanMMolloy
thought robots crushed apart frcquotes	RowanMMolloy
nanogeekette yay progress	RowanMMolloy
year lot interesting rightbyyou	RowanMMolloy
nlibrisveritas moffat gatiss wrote	RowanMMolloy
partnersformh video hope enjoyed	RowanMMolloy
current length video minutes exactly meh	RowanMMolloy
time finish btsov won will writing slower steady icantbelieveiwonthough nanowrimo	RowanMMolloy
question validate going permanent count nanowrimo help abouttowin	RowanMMolloy
thesprintshack joining momentarily today win ktogo korbust nanowrimo	RowanMMolloy
nano frozen today beautiful lots songs best movie incredibly good	RowanMMolloy
time big fight scene nanowrimo ktogo	RowanMMolloy
nanowordsprints close goal korbust writer will win nanowrimo iamonfire	RowanMMolloy
cantrelljason update count bring nanowrimo thisisnowbotheringme	RowanMMolloy
nanogeekette incredibly jealous hungrywritersarenotfun nanowrimo	RowanMMolloy
minutes gotime nanowrimo atleast	RowanMMolloy
ericnentrup today tomorrow nanowrimo	RowanMMolloy
official goal hit friday day early busy times day total nanowrimo writinglikecrazy	RowanMMolloy
frinightwrites minutes writeclub	RowanMMolloy
going head night full day work tomorrow better write good material tomorrow write garbage today	RowanMMolloy
officially novel wattpad today nanowrimo	RowanMMolloy
written today dnanowrimo gettingbackontrack	RowanMMolloy
break yay nanowrimo	RowanMMolloy
becomingcliche pie nomnomnomnom	RowanMMolloy
officially nanowrimo today ton planning onlytimeshalltell writinglikecrazy	RowanMMolloy
coreyvidal bufferfestival headed canadian eh daily vloggers	RowanMMolloy
nanowordsprints thought clouds introduce favourite minor character outline	RowanMMolloy
heyimissie tsbnick nickabella	RowanMMolloy
nanowordsprints serenalawless wc nanowrimo	RowanMMolloy
corradocoia change preferences bufferfestival orders will best	RowanMMolloy
happy birthday corradocoia	RowanMMolloy
tsbnick books cool things	RowanMMolloy
mackavaldez tsbnick nope	RowanMMolloy
hoping speck dust picks speed drop conflicted	RowanMMolloy
alextwestlake heyimissie people fun	RowanMMolloy
heyimissie tsbnick shipitlikefedex	RowanMMolloy
excited ukulele duets heyimissie thiswillbefun tsbnickyear	RowanMMolloy
wheezywaiter write tv	RowanMMolloy
alextwestlake absolutely terrible harry potter puns tsbnickyear	RowanMMolloy
corradocoia guessing older help	RowanMMolloy
sir sir service sir favourite inthiswillbeagreatbook	RowanMMolloy
novel validated guess breather nowcampnanowrimo	RowanMMolloy
will win tonight will win tonight ktogo kgoal campnanowrimo determined	RowanMMolloy
word percentdone sohappy knight campnanowrimo campnano excited	RowanMMolloy
annoys friends guy people thinking dating great talk love alex haveaboyfriend	RowanMMolloy
iron man movies day stan lee cameo stark steal moustache rdj ironman summer	RowanMMolloy
you good person occasionally	RowanMMolloy
realjohngreen hit fans	RowanMMolloy
woo hoo voted win mybbb destinations ultimate rtw trip cash	RowanMMolloy
corradocoia sucks thing fridge house post office	RowanMMolloy
nanowordsprints works find word works moment stays	RowanMMolloy
corradocoia happy birthday card will house week slow mail slow fun halloween haunt	RowanMMolloy
corradocoia stickynoteanswers wrong turn	RowanMMolloy
mrrpmurphy twitter literally favorite thing	RowanMMolloy
magical glorious story tyleroakley met chriscolfer	RowanMMolloy
coreyvidal tomorrows gathering official	RowanMMolloy
samanthafall po box	RowanMMolloy
hankgreen watching scishow video science class	RowanMMolloy
congratulations ryerson alumni catmackinnon actranat woman year	RyersonU
tapping perspectives solve community rbc immigrant diversity inclusion event	RyersonU
whyryerson openhouse day	RyersonU
tonight perfect night cityhall selfie lights blue gold ryersonrams love werrams	RyersonU
beat procrastination study night long rslc tonight study blitz full schedule events	RyersonU
ayymolina study time	RyersonU
considering ryerson students sharing influenced	RyersonU
community transformation cafe series tomorrow social innovation	RyersonU
feel receive feedback writing ryerson students	RyersonU
nights win lancers rams hoping bring oua banner fans werrams cis	RyersonU
takes village resettle family students staff faculty lifelinesyriaru	RyersonU
swing trsmryersonu today free legal advise clinic	RyersonU
engineering students will push vw beetle campus hours starting thursday help raise money sickkids	RyersonU
congratulate viola desmond award recipients evening ryersonedi	RyersonU
ryerson interim president mohamed lachemi speaks viola desmond award ceremony	RyersonU
mushtabaholwayy time charged exams energy	RyersonU
touch dial ryerson internet radio station will airwaves cjru march st	RyersonU
artmblake happening day today mattamyac	RyersonU
floor rslc special dedication sarabjit marwah learning exchange	RyersonU
diversity matters ryersonreview dissects complicated diversity canadians understand	RyersonU
congrats krystenconnely thesaad jesse berger winning theeconomist real vision investment case study competition	RyersonU
gretmoll schedule winter exams will posted march	RyersonU
chance check air tonight led installation aimed raise awareness homelessness	RyersonU
multivursqueen anticipate service disruptions pm classes continue monitor updates posted	RyersonU
kerriandreas open tonight checking twitter changes	RyersonU
capture beauty snowy campus enter chance feature photo ryersonalumni post card	RyersonU
ryersoncue kirstyduncanmp announced federal funding including dr bala venkatesh work nserc	RyersonU
ximadreamer question find ticket price breakdown	RyersonU
renowned filmmaker atom egoyan joins tiffnet ryerson mindandaction panel tues mar	RyersonU
learn jonathon anderson approaches technology incorporates innovation interiordesign	RyersonU
myriiiammm definitely to interrupt study process experiencing wifi disruption ryersonfixit	RyersonU
camjamesmr services team happened	RyersonU
find eggythemascot rslc celebrating rslcyr students	RyersonU
dianekashin future engineers building	RyersonU
ryerson open classes running scheduled monitoring weather expect disruptions rest day	RyersonU
rachcosta monitoring weather closely changes schedules will appear front	RyersonU
partnering tangerinebank launch thinkubator will drive innovation fintech	RyersonU
itsjohninnit monitoring weather situation day checkin updates	RyersonU
create safe efficient healthy transportation options join panel discussion thursday	RyersonU
board governors senate election campaigns candidate	RyersonU
rslc turns share favourite place study relax classes hashtag rslcyr wait hear	RyersonU
build skills change weekend day program campus oliviachow visit	RyersonU
attend akua benjamin legacy project lecture tonight tune live stream starts	RyersonU
sarahsalutesyou campus photos scenic locations	RyersonU
winter capture beauty campus photo featured ryersonalumni calendar	RyersonU
uberlearn great photo forget enter ryersonalumni photo contest	RyersonU
james paul gee discusses learning games changschooltalks	RyersonU
build knowledge discussions justice walks social media workshops jack layton leadership school	RyersonU
learn ryersonsafety helps faculty staff students sustain safe secure environment	RyersonU
hey ryerson students chance win starbucks gift card thoughts rslc	RyersonU
business basketball panel special guest nba hall famer wayne embry start eng	RyersonU
dmzsession started tune	RyersonU
tonights ryersonrams hockey game snap pic norm help raise funds orphans ru osp	RyersonU
congratulations ekuzheleva big win	RyersonU
ryerson marketing professors weigh sb ads torontostar	RyersonU
yungbabyqirl send direct message details contacted ryerson	RyersonU
earlier today jennvalentyne stopped learning support center hope caught live bttoronto	RyersonU
eggy will rslc tomorrow morning making appearance bttoronto join start week tv	RyersonU
video series aboriginal role models inspires future learners attend university futurefurther cdnpse	RyersonU
usetherightwords join discussion reporting sexual violence feb	RyersonU
policy studies phd candidate bridges generations groundbreaking indigenous governance learn	RyersonU
colin robert phillips traditional phd student read remarkable story ryerson onpse students	RyersonU
matter long work account prepared flood ned ryerson content february bing	RyersonU
sisters ramily great video ryerson womens basketball players keneca siki ryersonrams werrams	RyersonU
amazing student nominate dennis mock student leadership award feb	RyersonU
ryerson faculty members interview topics edaw onpse	RyersonU
bonnie patterson appointed distinguished visiting professor trsmryersonu	RyersonU
healthy safe wonderful weekend ryerson tweet monday	RyersonU
find to job career compass ryersonu career job search guide	RyersonU
learn pros cons journalism experts debate neutrality journalism ryersonrjrc feb	RyersonU
great opportunity work coming artists edition photobook starts today	RyersonU
tips ryerson best practices enhance privacy protection honour data privacy day jan	RyersonU
mental wellbeing friendly reminder takecareru bellletstalk	RyersonU
ceremonial ribbon cutting ibest biomedical zone stmikeshospital biomedicalzone ryscidean rezamoridi	RyersonU
filmmaker marketing executive barry avrich appointed distinguished visiting professor ryersonfcad	RyersonU
check ryerson student contributions room opening weekend gladstonehotel	RyersonU
interested ryerson governance attend session board senate elections feb noon jor	RyersonU
trsmryersonu grad charith perera scores investment dragons den auto parts ecommerce company	RyersonU
yee haw jan annual country night mac grab hat mens hockey team brock free onecard	RyersonU
international issues discussion iid series hosts child soldier conversation michel chikwanine jan	RyersonU
aboriginal students finding respect healing opportunity difference social work program	RyersonU
attn students kick semester free hot lunch rlsc jan noon pm	RyersonU
grad students sign minute thesis competition jan showcase win cash prizes	RyersonU
ryersondas students years dascollab exploring human relationship water	RyersonU
mens womens ryersonrams basketball teams yorkulions wednesday	RyersonU
happy year university open today classes resume january	RyersonU
drop jorgenson lobby hot chocolate treats caroling santa tomorrow	RyersonU
confirm eligibility graduate officially graduated request letter ryerson	RyersonU
academic advisement report ramss monitor academic progress ryerson	RyersonU
chriscaluma internal phone	RyersonU
congrats rufeas professor seth dworkin young engineer award ospe peohq	RyersonU
difference holiday lifelinesyriaru volunteers donations syrianrefugees	RyersonU
missed ryersons hourofcode hosted ryscidean happened	RyersonU
join ryequity sanism stigma mental wellbeing talk dec pm pod ryersonedi	RyersonU
business leader stephen pumple appointed distinguished visiting professor ryersons rufeas	RyersonU
writing ryersonexams mtcc mins campus success	RyersonU
ryerson fashion comms student kelly ann nguyen true cost buying cheap clothes fastfashion	RyersonU
questions exam schedules locations bring answers ryersonexams	RyersonU
opinion matters public realm jan open house hear share ideas ryerson evolving campus	RyersonU
applied transfer credits review your transfer credit report ramss ryerson	RyersonU
checked brand refresh brand story story impact	RyersonU
confirm eligibility graduate officially graduated request letter ryerson	RyersonU
ryerson student kyjedward great piece macleansmag quest learn ancestral tongue ojibwe	RyersonU
hurrah ryersons goodbye president levy	RyersonU
curious steps receiving transfer credit visit steps ryerson	RyersonU
applied transfer credits review your transfer credit report ramss ryerson	RyersonU
tips exam season michelle green manager examinations special projects ryersonexams	RyersonU
tomorrow winter transfer credit deadline applied ryerson	RyersonU
join usetherightwords explore media coverage sexual violence dec	RyersonU
today sheldon levys final day president ryerson community toronto	RyersonU
academic advisement report ramss monitor academic progress ryerson	RyersonU
rsvp master professional communication info night december st ryerson	RyersonU
visit security ryersonrc illc lobby today tips safe ryersonexams	RyersonU
security will lobby slc today pm talking students personal safety exams visit	RyersonU
join share memories enjoy refreshments celebrate achievements president levy nov mac	RyersonU
rams player kristine yan battles injury ryersonrams ramily werrams	RyersonU
applications ricgallery photography fellowships close november photography blackstarcollection	RyersonU
good luck annu gaidhu ru student reigning india canada nominated ivhq volunteer year	RyersonU
curious st year join whyryerson chat pm hear students share experiencesadvice	RyersonU
kudelka meets ryerson dances performance original work renowned choreographer james kudelka	RyersonU
tonights night ryersondas hosts awards night student showcase paul cocker gallery pm	RyersonU
friday trans day remembrance join ryerson memorial noon rslc atrium	RyersonU
advised objects today animal organs student art project disposed victoria st	RyersonU
theatre school dance program staging original performance renowned canadian choreographer james kudelka	RyersonU
rsvp master professional communication info night dec ryerson	RyersonU
learn continuingeducation ryerson attend changschool open house nov	RyersonU
ryerson graduate maayanziv creates app leading welcoming accessible accessnowapp	RyersonU
licence access copyright expires dec learn commitment copyright compliance	RyersonU
prof myer siemiatycki transit will shape neighbourhoods ryerson torontostar	RyersonU
applied transfer credit required submit course outlines visit ryerson	RyersonU
december winter transfer credit deadline find apply ryerson	RyersonU
audition today pm ted rogers management conferences multicultural night march	RyersonU
attend evenings interactive lecture cathy crowe alex abramovich	RyersonU
prof frank russo brain body reacts music yahoohealth ryerson	RyersonU
chillin gould nov pm support united ruunited	RyersonU
icymi ryersondmz ranked st north america ubi global ranking ubiglobal startups entrepreneurship	RyersonU
december winter transfer credit deadline find apply ryerson	RyersonU
prof amatthewsdavid poisonous green pigments terrorized victorian fashion jezpictorial	RyersonU
hockey insider reporter alum bob mckenzie receives elmer ferguson memorial award hockey journalism	RyersonU
ramily cn tower stair climb support united nov ruunited	RyersonU
deantrsm talks globeandmail ryersonmbas ranking theeconomist ryerson	RyersonU
rams basketball teams opener varsityblues students faculty staff attend free onecard	RyersonU
ryerson host toronto charity homeless connect mattamyac sunday nov	RyersonU
taliaschlanger contributing wise	RyersonU
great weekend happy halloween forget turn clocks hour	RyersonU
grad students enter grad word second video contests win prizes totaling ryerson	RyersonU
brands forced stand issue quotes prof seung hwan lee yahoocanada	RyersonU
teen innovators frank andre heartwatch invent wearable heartmonitoring device biomedicalzone stmikeshospital	RyersonU
grab tickets ryerson theatre schools sixplay series suburban motel filthy rich	RyersonU
support cn tower stair climb united contributing ryerson rams fundraising goal ruunited	RyersonU
employee award nominations open nov nominate exceptional faculty staff member ryersonhr	RyersonU
canadian british election polls donald trump piece prof dktrdr washingtonpost	RyersonU
night astronaut chris hadfield will massey hall headlining sciencebased variety	RyersonU
rsvp tues info session ryerson professional masters diploma enterprise info privacy data protection	RyersonU
ryerson partners recommend strategies closing canadas bigdata talent gap	RyersonU
catch octobers sustainability matters newsletter online rsustainability	RyersonU
learn ryersons urban development master program rsvp oct open house	RyersonU
cur policy seminar oct ryersonfcs	RyersonU
cur policy seminar oct ryersonfcs	RyersonU
attend oct learn advances tech ryerson researchers students great discount	RyersonU
explore public cultural performance ryersonfcads performigrations exhibit oct	RyersonU
distinguished visiting professor stephen lewis speak alan whiteside hivaids controversies oct	RyersonU
help support community donation united ruunited	RyersonU
good morning ryerson happy election day exln	RyersonU
ryersons emergency awareness preparedness response procedures visit	RyersonU
rsvp learn ryersons urban development master program oct	RyersonU
employee award nominations open nominate exceptional faculty staff member today ryerson ryersonhr	RyersonU
hear lively thoughtprovoking ideas walrusmagazine talk oct trsmryersonu	RyersonU
check weegee murder business opens today ryerson image centre ricgallery	RyersonU
fall convocation today congratulations graduates roadfromryerson	RyersonU
grad students enter grad word second video contests win prizes totaling ryerson	RyersonU
happy tuesday ryerson wishing students study week wonderful break	RyersonU
changschool dean marieatryerson talks canadianliving adult education ryerson	RyersonU
ramily members starting thanksgiving long weekend early happy safe holiday remember ryerson will closed monday	RyersonU
mens hockey opener fri mattamyac onecard ticket ryersonrams games prizes	RyersonU
vote advanced polls drop ryerson student campus centre october	RyersonU
learn abt stick budget sign rudebtfree free financial literacy course students	RyersonU
ryersons trimentoring program turns year help raise days tmpturns	RyersonU
vote advanced polls ryerson student campus centre october	RyersonU
congrats arlene you ryeshomegrown ryerson	RyersonU
pillars ryerson student affairs mental eing	RyersonU
congratulations queensus arthur mcdonald winner nobelprize physics nobelprize cdnpse	RyersonU
thinking grad school rsvp oct yeates school graduate studies open house ryerson	RyersonU
drbenbarry surprisingly subversive mens loafer nytimes ryerson fashion	RyersonU
join oct gould victoria slc atrium raining learn united campaign ruunited	RyersonU
navneetr navneet metrolinx oversees app direct questions	RyersonU
goodbye shy ryersonpsych prof martin antony people develop shyness ryerson	RyersonU
ruservicehub find onestop shop student administrative	RyersonU
hmm familiar ramily	RyersonU
will donated trimentoring program tweet tmpturns tweeting ryerson	RyersonU
smlabtos polidashboard reveals people federal election cdnpoli elxn	RyersonU
grad student writing guru mark award recipient developed specialized graduate writing groups	RyersonU
dhps human rights services reflects dept advocacy fairness respect ryersonedi	RyersonU
socialmedia help hinder political debates prof gregelmer weighs cbcnews cdnpoli	RyersonU
happy tuesday forget vote favourite timberfever structure pm	RyersonU
paws furry friends rutherapydogs today lower gym khw pm	RyersonU
visiting ouf note dvp currently closed fall maintenance will reopen monday sept ryersonouf	RyersonU
future rams coming ouf don valley parkway will closed weekend plan ahead	RyersonU
attend soup substance blacklivesmatter equity social justice policing sept pod	RyersonU
latest news info campus coverage ryersontoday online email	RyersonU
plugndrives evdaytoronto underway ydsquare ryersoncue team	RyersonU
fashion industry injured women piece prof alison matthews david independent	RyersonU
attend soup substance blacklivesmatter equity social justice policing sept pod	RyersonU
happy yomkippur observing	RyersonU
prof chris macdonald companies making best employees miserable trsmryersonu cdnbiz	RyersonU
thinking grad school attend yeates school graduate studies open house oct ryerson	RyersonU
local candidates matter voters features prof daniel rubenson ottawacitizen cdnpoli	RyersonU
ryerson journalism student vanessafrancone scoop rbcs tiff red carpet correspondent	RyersonU
bustamyth ryscidean ryerson mythbustersto	RyersonU
director luis ospina talks work tiff premiere documentary started today	RyersonU
gritty underbelly manhattan weegees images display ricgallery oct	RyersonU
reminder ryerson will conducting fall fire drills legislative requirement buildings week	RyersonU
credit ratings budgeting planning life school learn personal finance skills rudebtfree	RyersonU
attend parttime job fair tomorrow pm gould st ryerson hireru	RyersonU
hadialramadan ryersonfcad admissions website follow whyryerson	RyersonU
learn personal financial concepts tools manage money better ryerson rudebtfree	RyersonU
congratulations prof marusya short listed cbc creative nonfiction literary award ryerson cbcbooks	RyersonU
krisnas reported earlier signs condoned ryersonu ryerson group	RyersonU
fyi ice cream	RyersonU
ahnansii offensive signs condoned ryersonu ryerson group report ryersonfixit	RyersonU
davidcommon ryerson security investigating matter info contact security securityryersonca	RyersonU
brinorris ryerson security investigating matter info contact security securityryersonca	RyersonU
joshharrower ryerson security investigating matter info contact security securityryersonca	RyersonU
angelajvink working remove offensive signs campus report location ryersonfixit	RyersonU
joshharrower working remove offensive signs oncampus report location ryersonfixit	RyersonU
happy anniversary toronto city hall npstoronto turned yesterday cityhall	RyersonU
ryersonu alumni weekend rediscover campus special tours ruaw	RyersonU
gingeeboi ryesu event questions directed	RyersonU
kgiles congratulations mindandaction social media contest winner email ryersoncgcegmailcom details	RyersonU
sign mosesstructures timberfever designbuild challenge deadline sept ryersondas	RyersonU
introducing courses schools faculties fall visit details ryerson	RyersonU
gogonchar ryesu send dm talk programs opportunities help	RyersonU
meet students starting lives ryerson fall rustudentlife roadtoryerson	RyersonU
will happen students mindandaction twitter instagram chance win rucampusstore	RyersonU
sharing norm mxxshah ryerson nothrowbackneeded	RyersonU
jacquelyncyr nice enjoy st day	RyersonU
enter win rucampusstore visit booth gould st share happen mindandaction	RyersonU
note farmers market location changed pitman quad today rueats	RyersonU
ratnaomi executive director gdxryerson discusses challenges refugees face coming canada nationalpost	RyersonU
changschool dean marieatryerson to school adult canadianliving	RyersonU
ratnaomi executive director gdxryerson quebec plans aid syrian refugees globeandmail syriancrisis	RyersonU
baldeep good morning great question ruservicehub	RyersonU
city long weekend check openstreetsto sunday pm ryerson	RyersonU
solutions life stressful situations quotes ryerson prof martin antony insidefitness	RyersonU
ready alumni weekend dj beer yummy food awesome giveaways ruaw	RyersonU
celebrate ryersons cultural diversity campus today ryersoniss	RyersonU
ryerson roadtoryerson guinnesschallenge	RyersonU
spanningthegaps bridges ryerson program powerful foundation student success	RyersonU
openstreetstos sept pm music workshops thercm activity hub bloorstculture	RyersonU
learn abt stick budget sign rudebtfree free financial literacy course students	RyersonU
happy day september ramily	RyersonU
congratulations president levy hell continue contribute strength entire post secondary system role	RyersonU
live tv students join corner gould victoria tomorrow bttoronto participants prizes giveaways	RyersonU
learn abt stick budget sign rudebtfree free financial literacy course students	RyersonU
order textbooks online sept chance win rucampusstore	RyersonU
ramspride alumni weekend ryersonrams york lions ruaw	RyersonU
excited rutherapydogs backs campus oweek roadtoryerson	RyersonU
contribute ryersons crossfaculty general interest publication follow ryersonfolio info updates	RyersonU
ideas ignite rsvp changschool continuinged open house aug ryerson	RyersonU
learn best barrierfree routes travel campus ryersonedi roadtoryerson	RyersonU
changschools conted open house aug learn oncampus online programs	RyersonU
khe khw will power pm aug will closed community ryerson	RyersonU
zrobichon good luck	RyersonU
cne starts today learn ryerson alum letsgototheexs general manager virginia ludy	RyersonU
don mythbustersto ryerson community members discount ontsciencectr sat	RyersonU
drbenbarry fall fashions blurred gender lines flarefashion ryerson fashion	RyersonU
arc eng building will power tomorrow pm will closed community ryerson	RyersonU
drop gould st farmers market pm grab lunch fresh ontario produce rueats farmersmktsont ryerson golocal	RyersonU
definition urban garden ryerson green roof helps toronto cool hot days today	RyersonU
men skirts drbenbarry fall fashions blurred gender lines flarefashion ryerson fashion	RyersonU
ryscidean weighs stem toys girls ryerson science	RyersonU
icymi southeast asian restaurant basil box will coming rslc winter ryerson	RyersonU
vic ced ima ric sbb will power tonight pm will closed community power will restored ryerson	RyersonU
trsmryersonu hosts aie ru conference august discuss building inclusive entrepreneurship ecosystem	RyersonU
city weekend check openstreetsto sunday pm ryerson	RyersonU
review list upcoming power disruptions closures ryerson campus ensure	RyersonU
happy farmers market day visit gould st pm great eats fresh produce rueats ryerson golocal	RyersonU
ryersonu resource centre open friday	SallySan_x
work ryersonslc level	SallySan_x
yall gotta follow desiperkins snapchat gotta watch fall butt youtuber myfave	SallySan_x
asklloydsbank called credit card team morning girl call helpful excellent service	SallySan_x
falling asleep class	SallySan_x
feet ice cubes	SallySan_x
lady quiet tonight stomping	SallySan_x
help win awesome giveaway dave lackie	SallySan_x
class tomorrow sad times	SallySan_x
tetsulineup hope queue	SallySan_x
tnluk love win help pay college tuition fees childhoodeducation millionaires	SallySan_x
school work motivation	SallySan_x
watching trainwreck will shit movie	SallySan_x
going toronto st	SallySan_x
everyday going feeling temporary life emotions feelings	SallySan_x
biggest decision month absolutely petrified	SallySan_x
colour wig ombre hairdressers blonde longhair	SallySan_x
royalmail tracking status showing item parcels rm days	SallySan_x
summer dior pink design eyes lips	SallySan_x
asosstylist asos find top luck stock	SallySan_x
biggest regret today napping wideawake	SallySan_x
chatimeuk open store liverpool afford travel manchester favourite milk tea	SallySan_x
specsavers collected lenses store march going hard prove months supply	SallySan_x
twitterversary twitter years apr	SallySan_x
god fuck couchtuner sort website	SallySan_x
wave radio entered fingers toes crossed	SallySan_x
londonfire elecsafetyfirst people dumb	SallySan_x
nice bath work	SallySan_x
people tight money	SallySan_x
long day cheshire oaks croft	SallySan_x
hate automated phone calls	SallySan_x
find decent work clothes	SallySan_x
hotelsdotcomuk vermont hotel hotelhunt	SallySan_x
bad sister completely forgot brothers birthday	SallySan_x
time roll bed start day	SallySan_x
gbcollege hey gb admissions cycle begun international applications applied st december	SallySan_x
hongbinss yeah week testing lipsticks	SallySan_x
zoeva brush sets expensive	SallySan_x
nb working glad three days	SallySan_x
hongbinss shopping cinema	SallySan_x
sister going town weekend bed oldage	SallySan_x
guy ordered meal walked pay mealdont	SallySan_x
hongbinss superstitious things	SallySan_x
win daisy marc jacobs worth sprinkleprizes sprinklecom	SallySan_x
win ladies rose gold plated michael kors watch model mk worth sprinkleprizes sprinklecom	SallySan_x
happy weather lot warmer roll summer	SallySan_x
win amazon voucher sprinkleprizes sprinklecom	SallySan_x
nb constantly posting food pics promotingobesity	SallySan_x
laptop piece crap support latest version java	SallySan_x
submitted application school	SallySan_x
gbcollege poor communication will submit application january	SallySan_x
nb yeah eat full stomach bed noget	SallySan_x
happened tulisas face drugs surgery	SallySan_x
comping fairy dryspells noluck	SallySan_x
debenhams order arrived time play	SallySan_x
gbcollege select countries citizenship but england uk allowed apply ece course	SallySan_x
mrkiplingcakes yay finally scousers	SallySan_x
excited black friday	SallySan_x
nb definitely going notes help	SallySan_x
nb sort questions interview	SallySan_x
nb bet will posting	SallySan_x
dog lovers check dog philly snapchat dogshowinphilly dogs doglover cuteoverload	SallySan_x
love nice palette toofaced remove box incase damage	SallySan_x
guess watch american horror stories iphone	SallySan_x
okmagazine davidbeckhamweb victoriabeckham beautiful pic	SallySan_x
time online assessment	SallySan_x
nb kind girl watch eat	SallySan_x
buy urban decay vice palette	SallySan_x
nb yeah cafe work sold red velvet cake popular huge fan	SallySan_x
nb claiming will find job november	SallySan_x
nb omg hope track ip arrest	SallySan_x
hongbinss find job save money	SallySan_x
hongbinss will beg jen eye lol	SallySan_x
piled pounds fatlife	SallySan_x
nb yeah guess	SallySan_x
nb excited cos spent xmas family years	SallySan_x
bucket list tomorrowland creamfields	SallySan_x
benefituk elleuk yay	SallySan_x
nb poked pen	SallySan_x
love faced palette everythingnice makeup	SallySan_x
chatimecanada locations live chatime opening stores liverpool manchester	SallySan_x
arghhhhhh week mobile number shit	SallySan_x
nb person tweet lol nofriends foreverlonely	SallySan_x
hate people partner	SallySan_x
nb yeah misleading haha	SallySan_x
hongbinss september congrats uni going	SallySan_x
nb long story good good	SallySan_x
blasting tiestos album	SallySan_x
finally dress aunties wedding	SallySan_x
nb lost weight ha	SallySan_x
hardwell vote top djs	SallySan_x
nb ssan instagram	SallySan_x
nb sweet adorable	SallySan_x
nb kidding working	SallySan_x
bottom feet hurts	SallySan_x
digidreamsfest fun giveaway gutted	SallySan_x
digidreamsfest app suppose notifications	SallySan_x
nb learn best slut	SallySan_x
orange black better good netflix comedy	SallySan_x
nb stupid uneducated people	SallySan_x
learn contour face slimmer	SallySan_x
mccoys years mccoys	SallySan_x
nb good books recommend	SallySan_x
nb yeah true remember people married young age	SallySan_x
nb face fail complain	SallySan_x
nb british sense humour	SallySan_x
nb skype tomorrow uk time	SallySan_x
nb yeah disrespectful hard send quick text msg guys suppose meet	SallySan_x
nb whimp steel lol	SallySan_x
nb yeah understand sense humour	SallySan_x
stay bed hot sunny	SallySan_x
mcdonalds vanilla iced coffee taste good	SallySan_x
nb good xx	SallySan_x
work long weekend	SallySan_x
nb hope offer	SallySan_x
nb will hate	SallySan_x
nb love iphone	SallySan_x
nb arrived safely	SallySan_x
coming toronto laidbackluke	SallySan_x
nb good updated	SallySan_x
going digital dreams veld	SallySan_x
spring today winter tomorrow bipolarweather toronto	SallySan_x
chatimeuk omg find chatime uk taro milk tea today store toronto	SallySan_x
nb serious apply mum lost birth certificate	SallySan_x
hate hate hate sick	SallySan_x
nb will forward snaccckkksss	SallySan_x
nb exciting hard sleepover	SallySan_x
urban decay naked palette fragile nooner cracked drop	SallySan_x
eatmandarin will valentines day	SallySan_x
nb argue stupid things things worth arguing	SallySan_x
torontoi piss working	SallySan_x
best night martingarrix absolutely smashed night uniun hope will summer festivals	SallySan_x
walking dead season netflixca	SallySan_x
best deal shoppers dior mascara set win	SallySan_x
nb to zealand september months save	SallySan_x
pinkystoronto explains work north building will pop south building tomorrow	SallySan_x
love app frmheadtotoe	SallySan_x
nb miracle post hrs ago netflix defiantly life	SallySan_x
started day slamming dishwasher door finger work defiantly great start	SallySan_x
armin van buuren will playing metro convention centre basement top floor ehh	SallySan_x
jeez cut carbs start diet	SallySan_x
netflixca amazing needed	SallySan_x
today day stuff face unhealthy food tomorrow will start healthy diet resolutions healthy	SallySan_x
work quiet today huge surprise	SallySan_x
theguvernment trip guv	SallySan_x
nb happy year	SallySan_x
jessicasanx photo sausage hasbrown casserole lol	SallySan_x
nb celebrate christmas happy holidays	SallySan_x
nb hmm lol independent bit	SallySan_x
nb serious depends money	SallySan_x
dress saturday night	SallySan_x
you hate job lazy bed ready	SallySan_x
stomach small full mini pizzas	SallySan_x
asosheretohelp asos restock items	SallySan_x
nb anemic blood cells normal	SallySan_x
love sister jessicasanx	SallySan_x
devastated dress wanted stock asos	SallySan_x
nb will private message proper conversation xxx	SallySan_x
nb surprises kids girl extremely rude nasty	SallySan_x
nb told sister teaching kids reply hahaha funny surprised	SallySan_x
nb hopefully find	SallySan_x
jeremitsme comment allezvous	SallySan_x
working weekends mad hate job	SallySan_x
yyifans remember big promised jess mini big better	SallySan_x
happy spooky halloween	SallySan_x
nasima told messaged	SallySan_x
nasima pizza today lunch eat lot salad day	SallySan_x
bit shopping therapy dufferin mall grocery shopping walmart	SallySan_x
yyifans nooooo years will anythin bring life lol goin to computer shop	SallySan_x
nasima start keeping track hours	SallySan_x
nasima second time underpaid fact payment will screwed	SallySan_x
nasima omg bad hazard drivers pedestrians	SallySan_x
poor poor poor laptop	SallySan_x
spent hour digging winter clothes packing summer clothes goodbyesummer	SallySan_x
bed shower waste day bed	SallySan_x
nasima nasima times amount times brush things ridiculous	SallySan_x
god extra day submit grades ryerson	shawnaoh_
early dismissal tomorrow	shawnaoh_
eat eat wear wear wanna	shawnaoh_
rip retail workers today	shawnaoh_
megan foster booking third tomorrow u worry	shawnaoh_
hurry winter break	shawnaoh_
megan foster cool tho	shawnaoh_
supposed pass bio fun	shawnaoh_
thought grade hard	shawnaoh_
eating spring rolls bath life better	shawnaoh_
hey buy vance joy tickets birthday	shawnaoh_
twerkling times changed	shawnaoh_
blessed live life live	shawnaoh_
wantneed cycles antm netflix	shawnaoh_
hollyovington best fun time drunk pass	shawnaoh_
quiet soft voices	shawnaoh_
love nasal infections fucking love	shawnaoh_
rileyperri fuck riley time	shawnaoh_
hate hate hate hate physics	shawnaoh_
megan trainor vancouver tickets	shawnaoh_
telus wifi worst things	shawnaoh_
twerkling sarajangster sara literally boat	shawnaoh_
joanneoh grounded provincials	shawnaoh_
disneyland tanner killing	shawnaoh_
jayleenaustria twitter dp omg love	shawnaoh_
twerkling laugh fucking choke	shawnaoh_
feeling chemistry mark lol	shawnaoh_
tanner jieun sleeping sitting table drinking water	shawnaoh_
anna jieun intoxicated	shawnaoh_
luv stanley park	shawnaoh_
allybrinn talk shit hit	shawnaoh_
megan foster loveyy gr	shawnaoh_
twerkling love lots fucking ugly	shawnaoh_
hate olive deleting	shawnaoh_
oliviashannnon literally drake	shawnaoh_
boys wearing shorter shorts	shawnaoh_
oliviashannnon eat shit	shawnaoh_
year today fml	shawnaoh_
kaileyyyyyyyy slutty whore	shawnaoh_
kimberlyyfaye kianlawley lov hard	shawnaoh_
wanna watch gossip girl season orange black	shawnaoh_
replace people puppies	shawnaoh_
blair waldorfs bitchy asian sidekick	shawnaoh_
weekend watch care	shawnaoh_
twerkling kimberlyyfaye lol tanner	shawnaoh_
wanna slight infection nasal passages hot	shawnaoh_
kaileyhbu sending card year will fuckin arrive	shawnaoh_
jaeinjeong defence states	shawnaoh_
happy valentines day	shawnaoh_
science provincial tomorrow	shawnaoh_
god semester break starts days	shawnaoh_
jaeinjeong wrong context	shawnaoh_
thelifeofalicia frying banana bread buy social life	shawnaoh_
guys peed year	shawnaoh_
merry christmas slaves	shawnaoh_
money buy cute christmas things room	shawnaoh_
zoey netflix understand	shawnaoh_
guys worst fucking wifi sos live	shawnaoh_
nightowl hope add seattlebellingham bc	shawnaoh_
hombosexuals pain thought	shawnaoh_
life basically annaastren	shawnaoh_
vancoiver sos live	shawnaoh_
jamalabc floral crocs	shawnaoh_
rileyperri bring louis harry harry	shawnaoh_
totally bombed test shawna	shawnaoh_
touches bc free country	shawnaoh_
science tests exist	shawnaoh_
making realize love electricity	shawnaoh_
maciverjenna forgot china lily	shawnaoh_
michael sos feel	shawnaoh_
falling love american horror story	shawnaoh_
heaven place earth	shawnaoh_
kaileyhbu happy free confused lonely time	shawnaoh_
hombosexuals acne day ahahaa	shawnaoh_
xmatthx matt tweeted ahhhhhh	shawnaoh_
sarajangster bring babe	shawnaoh_
montsedeveras sinigan love	shawnaoh_
joanneoh going doubt will bc naked shower	shawnaoh_
suck webcam pictures pls rid packaging	shawnaoh_
pay attention class	shawnaoh_
hola playlistlive chasegoehring perform hm hell rock socks chasegoehringtoplaylist	shawnaoh_
hollaclare holla baby	shawnaoh_
wow school spirit blk red	shawnaoh_
free pink dreamcatcher belly button ring lol	shawnaoh_
sosassbutt follow bc yolo sos live	shawnaoh_
kaileyhbu ya coming vancouver check	shawnaoh_
tbh grade going worse	shawnaoh_
will follow hey sos	shawnaoh_
yup life officially sucks	shawnaoh_
bc love lots breakingthelaw	shawnaoh_
ashton sos ashton birthday holla	shawnaoh_
kristinnitara ya birthday sushi lunch downtown	shawnaoh_
hours minutes birthday what	shawnaoh_
resolution sex bc will pregnant sink will leak toilet will clog going cry	shawnaoh_
songs repeat omg sos	shawnaoh_
sarajangster girl aint	shawnaoh_
hombosexuals rock star	shawnaoh_
word fuck regular word	shawnaoh_
wtf kids bus going downtown	shawnaoh_
sarajangster anus begs differ	shawnaoh_
sarajangster fuck favoriting phone vibrating dildo	shawnaoh_
literally traffic worst bus traffic worstest	shawnaoh_
hell kodaline coming vancouver	shawnaoh_
curtisyourwords voice inside headddd	shawnaoh_
guys homework playing fake eyelashes	shawnaoh_
feels good aquarium tbh	shawnaoh_
fuck channing tatum gorgeous	shawnaoh_
love shawna chaseyourwords live	shawnaoh_
holy shit masterchef fucking intense rn shitting	shawnaoh_
guys bed sos live	shawnaoh_
watching losers yell eachother inthetubwith sos sos live	shawnaoh_
online dickheads sos live	shawnaoh_
hashtag pray jenettes vagina	shawnaoh_
follow jamesyourwords cares	shawnaoh_
jamesyourwords hope today	shawnaoh_
guys follow twitter love chrisyourwords live	shawnaoh_
ashton sos pay attention science class ya follow	shawnaoh_
closing windows thunderstorm bc feel underwater submarine	shawnaoh_
amieisfierce started today tbh bc tumblr listened holy fuck good	shawnaoh_
michael sos calum sos luke sos likes bran ladies years	shawnaoh_
gno goooo omg	shawnaoh_
haileymkrag aw hailey dp aw honoured	shawnaoh_
jenna oldest people fucking theatre haahahhahaha	shawnaoh_
michael sos thought oops	shawnaoh_
god jsut ugh dylan	shawnaoh_
honey boo boos family tbh	shawnaoh_
calum sos waiting long day wow	shawnaoh_
jennamaciver ya suck dick	shawnaoh_
calum sos aw calum boy crushes aw	shawnaoh_
jakeseed wildest dreamsssss	shawnaoh_
worse translink skytrains	shawnaoh_
michael sos ashtons butthole	shawnaoh_
calum sos hoodrat calum hoodrat ha ha ha	shawnaoh_
hombosexuals nick omfg shshsh	shawnaoh_
hombosexuals calums butt	shawnaoh_
fml science weirdddddddd	shawnaoh_
casandralyons pretty face	shawnaoh_
twitter archive worst decision life omg grade dark year	shawnaoh_
cried screen offline tbh sos	shawnaoh_
michael kiss calum ashton cheek bc lazy kiss luke sosanswerme	shawnaoh_
luke wearing sunglasses inside sosanswerme	shawnaoh_
calum mighty fine sos live	shawnaoh_
luke sos love	shawnaoh_
rogers arena cab waved omg calum sos	shawnaoh_
kaileyhbu la la la la la la la la la la ife	shawnaoh_
pinterest addicting wtf	shawnaoh_
nightowl crying bc	shawnaoh_
calum sos making life eternity noticing sound	shawnaoh_
nightowl ya good week absolutely stay bed day	shawnaoh_
michael sos bed michael	shawnaoh_
amandaayall sounds gr better great ha	shawnaoh_
hombosexuals japadog sex	shawnaoh_
sos will bby	shawnaoh_
ashton sos ilysm	shawnaoh_
days pure leisure jennamaciver	shawnaoh_
ashton sos ha ha ha ha ha funny ashton	shawnaoh_
jennamaciver ice cream cake	shawnaoh_
luke sos omg	shawnaoh_
luke sos eggs	shawnaoh_
ashton sos tacos	shawnaoh_
baconiam aw nice bby	shawnaoh_
hollaclare watch dad will hell fun entire thing	shawnaoh_
baconiam lucky shit god	shawnaoh_
holy shit breaking amish going ruin	shawnaoh_
wow jennifer lawrence	shawnaoh_
hombosexuals hahahhahahhahahhaha beautiful best friend aw cute aw love	shawnaoh_
justin bieber chest hair laugh	shawnaoh_
calum sos naked	shawnaoh_
haileymkrag life ruined	shawnaoh_
doubledazzle hate ugly	shawnaoh_
calum sos rly	shawnaoh_
nightowl luke luke omg	shawnaoh_
hombosexuals sound miguel	shawnaoh_
jennamaciver dying bc faggot	shawnaoh_
calum sos vancouver	shawnaoh_
signing hot yoga worstbest decision life	shawnaoh_
goodnight whispered post concert depression remember concert sos shirt	shawnaoh_
basically arena oclock stood ledge concert luke niall zayn louis liam calum life	shawnaoh_
waited year months concert full permission carrot	shawnaoh_
ya head vancouver faster pls onedirection sos	shawnaoh_
wait oops meant	shawnaoh_
calum sos love meeeeeeee	shawnaoh_
kaileyhbu going laugh hard posts vancouver	shawnaoh_
rly dolphins teeth shaped	shawnaoh_
michael sos follow spree bc	shawnaoh_
sos follow buy food sosfamilyfollowspree	shawnaoh_
jaeinjeong god yayayyyyyy sunday yay aw	shawnaoh_
poop touching insides	shawnaoh_
rly pee rly move life	shawnaoh_
annaastren yay swag yolo	shawnaoh_
hollaclare clare love	shawnaoh_
realliampayne help follow spreefollowing	shawnaoh_
single choice choice	shawnaoh_
realliampayne best song wtf omg crying help sweet jesus	shawnaoh_
medication helps esteem help	shawnaoh_
bed bath semester	shawnaoh_
shakespeare hope die	shawnaoh_
lying harry styles dirty things	shawnaoh_
danielle fucking peazer answered askfm question sobbing bc life hear sobbing bc	shawnaoh_
nights rest paradise	shawnaoh_
niallonnylon jakeseed whores	shawnaoh_
niallonnylon uh yahhhh bby	shawnaoh_
bachadam english butthole tight	shawnaoh_
fuck read someones diary hidden reason read	shawnaoh_
glee omfg thetearsarereal	shawnaoh_
maciverjenna thought odyssey written shakespeare	shawnaoh_
bachadam fine fineliner	shawnaoh_
niallonnylon exactly win ha xo	shawnaoh_
ew today sucked bad	shawnaoh_
kmichaela jaeinjeong yayz	shawnaoh_
kmichaela best whore	shawnaoh_
niallonnylon samess bby	shawnaoh_
guys kissing single painfully aware	shawnaoh_
jittery tumblr start working omfg	shawnaoh_
jakeseed wow ily	shawnaoh_
themainsqueeze wow love lemonade best	shawnaoh_
niallonnylon tumblr filipino loser	shawnaoh_
harry styles attractive holla	shawnaoh_
doubledazzle taylor swift	shawnaoh_
hello beautiful starbucks	shawnaoh_
danniprasad jennamaciver sexless approached	shawnaoh_
jesus ciara beautiful video	Simon_Pella
love michelle obama	Simon_Pella
watch youthvideo troyesivan	Simon_Pella
simonpella stupid time	Simon_Pella
thomaskillip simply sound good	Simon_Pella
jeeyuntv recognized room awesome job	Simon_Pella
history teacher bae	Simon_Pella
idris oscarnoms beasts nation killed movie	Simon_Pella
feeling cloud happiness	Simon_Pella
hotlineting literally life	Simon_Pella
oliver jeweller absolute	Simon_Pella
changed profile picture french flag feel reassures victims families people forgotten	Simon_Pella
wtf people sikh poor guy	Simon_Pella
danjaapapajani thepussyasylum alex forgive	Simon_Pella
kids coming door costumes eyes halloween cute tho	Simon_Pella
teacher talks slow class feel longer	Simon_Pella
revival pretty good	Simon_Pella
ydkm donald trump american	Simon_Pella
tired hearing shootings hard pass guncontrol uccshooting	Simon_Pella
wait watch love priyankachopra	Simon_Pella
norm good point	Simon_Pella
ydkm vrxox ixnpurpose shawtytofresh sounds vrxox	Simon_Pella
shazam bullsht talkin destorm power kingkeraun	Simon_Pella
event recap vmas nowwatching	Simon_Pella
ydkm good facetime tonight	Simon_Pella
driving driving crazy wild	Simon_Pella
ydkm hey shu	Simon_Pella
vine dank memes	Simon_Pella
feeling darkness inspired imjakepaul lance vine lance	Simon_Pella
adampisarek wake early best weather dark reflects feeling	Simon_Pella
canadian grandma maple leaf socks vine andrewaubry	Simon_Pella
nickiminaj backtogether video fun idea robin	Simon_Pella
ydkm travis scott	Simon_Pella
scott dani days weeks	Simon_Pella
nickiminaj learned lyrics faster nicki song verse flawlessremix	Simon_Pella
police learn weapon and	Simon_Pella
nickiminaj making trip toronto anytimetomorrow	Simon_Pella
tired terrible attitude	Simon_Pella
viner macys shoe department vine kindasarahx	Simon_Pella
twitter beef helping	Simon_Pella
dude tryin waste big today vine stephangray	Simon_Pella
janko family vine georgejanko	Simon_Pella
srxo ya song	Simon_Pella
cuz remake vine justtylert	Simon_Pella
nickiminaj meekmill toooo	Simon_Pella
bout die hungry af vine michaelwashh	Simon_Pella
tenis vine queridoantonio	Simon_Pella
dads mustache creeps vine dannygoonzalez	Simon_Pella
side chick overstep boundaries elisa nadiya vine ichvse	Simon_Pella
vrxox nickiminaj grade	Simon_Pella
women slammed ground drunk guy beat doctor lab coat	Simon_Pella
somalians beautiful omg	Simon_Pella
best friend find combined srxo	Simon_Pella
yohaaam vine vine rkiye	Simon_Pella
nickiminaj guys honestly stopped dead feelingmyselfvideoontidal	Simon_Pella
srxo rude af	Simon_Pella
bitchy girl huge rush going vine hannah pilkes	Simon_Pella
friend vine benleviross	Simon_Pella
killed vine guysnolives	Simon_Pella
girl slaps man warantzatime vine anwarwj	Simon_Pella
dead nickleback vine reneelyon	Simon_Pella
famousclassy happy birthday	Simon_Pella
watched intervention sandi sober months reunited daughter jumped cheered lol gosandi	Simon_Pella
worry thingsage adaline feeling feels	Simon_Pella
punjabi man terrible therapist suicidal thoughts vine jusreign	Simon_Pella
aye dis meghantrainor	Simon_Pella
nap time best time dream	Simon_Pella
meghantrainor tonight toronto	Simon_Pella
srxo chem bio	Simon_Pella
nicki minaj day convo phone nickiminaj	Simon_Pella
swain carrying gold	Simon_Pella
srxo wtf shu	Simon_Pella
teenage girl twitter	Simon_Pella
nickiminaj stink surprise roman verse	Simon_Pella
nickiminaj kiss face missing roman verse	Simon_Pella
thepinkprint amazing good job nickiminaj songs lied gp	Simon_Pella
sherway lost seersears find yorkdale better beca seer gabgap nice thing nonna	Simon_Pella
shanghai math student hood fast lol nickiminaj thepinkprintonitunes	Simon_Pella
congrats nickiminaj deserve number spot thepinkprint	Simon_Pella
fire school alarm evacuated smoke halls cheap ass school	Simon_Pella
girl follow feel weird vine	Simon_Pella
coming canada nickiminaj heat cold	Simon_Pella
americanhorrorstory ahsfx lanadelrey gods monsters	Simon_Pella
person song max jr vine	Simon_Pella
breaking news ebola feeling wmax jr vineapp	Simon_Pella
katieqlowes lol scandai	Simon_Pella
person letshangout vineapp	Simon_Pella
rosalina jaymundo chris jessicavanessa vineapp	Simon_Pella
weaker goat vineapp	Simon_Pella
iphone phone homegirls sitting lookin bosos tripping hoes realest fo realest rap	Simon_Pella
parents relate dad pic mom hashbrown cool hashbrownselfie	Simon_Pella
dontyoujustlove parents snake plans	Simon_Pella
nickiminaj catchiest song heard	Simon_Pella
srxo dvd kraft dinner	Simon_Pella
people pictures cars belong vineapp	Simon_Pella
coffees time effin	Simon_Pella
happy birthday bud	Simon_Pella
park good place play ruben	Simon_Pella
shogunmifune lol long laughed good	Simon_Pella
days ago selfie rip grandpa	Simon_Pella
nickiminaj jeeesuz beautiful song onrepeat pillsnpotions	Simon_Pella
people mins facebookspringcleaning	Simon_Pella
thekaitlynmini buongourno bella	Simon_Pella
famous oscar winning redviolin	Simon_Pella
kerrywashington kidding scandalfinale	Simon_Pella
yelling teacher shushawnaa	Simon_Pella
favourite film time	Simon_Pella
tbt better days	Simon_Pella
canada beat usa sochi	Simon_Pella
blue ivy drink grammyhoney year newest	Simon_Pella
going feelinglike usainbolt	Simon_Pella
nickiminaj mom family alike lucky xd	Simon_Pella
school dance whao	Simon_Pella
developed improved laugh yesterday	Simon_Pella
bus empty firsttimeforeverything	Simon_Pella
lip gloss poppin	Simon_Pella
wowa terrorist attack mall nairobi	Simon_Pella
raplikelilwayne pussy pussy pussyyeahthats aint awussy wussy wussy	Simon_Pella
ladygaga reminds grade	Simon_Pella
shushawnaa find job	Simon_Pella
hindi beautiful language love bollywood priyankachopra	Simon_Pella
nickiminaj verse richfriday verses love pace	Simon_Pella
outlet mall shirt	Simon_Pella
dad play risk takes week play	Simon_Pella
great job bottle nickiminaj	Simon_Pella
waste lot time	Simon_Pella
simonasantagato um answer	Simon_Pella
juliaaabursa mi favorito amiga arriiiiba arriiiiba	Simon_Pella
deaf camp lilysumms tomorrow	Simon_Pella
happy canada day	Simon_Pella
horses backflips whew funny	Simon_Pella
nickiminaj wait twerk	Simon_Pella
thepurge awesome lilysumms	Simon_Pella
jesus amadeus grimm hell	Simon_Pella
heart broken impossible scottishversion	Simon_Pella
iisuperwomanii ellen lol	Simon_Pella
people helping ifeelloved	Simon_Pella
nickiminaj ciara love	Simon_Pella
baby sitting life	Simon_Pella
shut grandma jokinggrandma bash face	Simon_Pella
read head studder	Simon_Pella
thepussyasylum tomorrow film	Simon_Pella
elastics eat live	Simon_Pella
tasiasword damn amazing heaven	Simon_Pella
prayforboston people shit killing	Simon_Pella
funniest thing amazing job esa drama	Simon_Pella
thepussyasylum check facebook	Simon_Pella
reading book english minute	Simon_Pella
mentionsomeoneimportanttoyou shushawnaa thepussyasylum die	Simon_Pella
jordankmills love dimples	Simon_Pella
justinbieber instagram nickiminaj	Simon_Pella
pillows lil wayne	Simon_Pella
rob ford worst public speaker heard topoli	Simon_Pella
best moment slips falls front	Simon_Pella
hate english hate poems hate expressing	Simon_Pella
caught illegal footage crown jewels delete fml	Simon_Pella
bitches stole seats	Simon_Pella
harlem shake laugh hard	Simon_Pella
grammys rihanna amazing hair	Simon_Pella
jinx owe sofa shushawnaa	Simon_Pella
selmaalameri kidding holy chose ttiertierra good worry ugh	Simon_Pella
shovelled neighbours driveway feel star	Simon_Pella
question nasty hope reference	Simon_Pella
nominate iisuperwomenii shorty award videoblogger funny shit	Simon_Pella
uberfacts feet spider nehasati	Simon_Pella
ready min mrsfairclough	Simon_Pella
adampisarek dat waz	Simon_Pella
supporting kids cancer inside ride	Simon_Pella
beyonce video spree	Simon_Pella
shushawnaa life fuck kim	Simon_Pella
replacesongtitleswithvagina nicki minaj pound vagina	Simon_Pella
thehobbit amazing good lotr amazing	Simon_Pella
finally stage braces today	Simon_Pella
stealing golfwanghoe jokes muahahaha	Simon_Pella
nehasati simonpella interaction gelatinous nehasati	Simon_Pella
teachers min studying subject night min snack breakwe opposite	Simon_Pella
evacuate building public service announcement evac nickiminaj bitch shut fck lmfao	Simon_Pella
golfwanghoe lol daniel scott fucking hide phone hour hour telling dumb	Simon_Pella
people profile serious wtf	Simon_Pella
kendall jenner runway vogue paris vogueparis	styleofthesix
speakcomedy bc hate babbarsahil	tanya_babbar
