meghanrocca tiny grey kittens	AHKru
dicaprio learn hiddleston elba walk major gait improvement needed eastwest footed waddle oscars	AHKru
styleit shouldve venti	AHKru
hemibenno half cup coffee cup	AHKru
feeling head imdb confirm role so bad channingtatum goldenglobes	AHKru
dropped package mailed days ago post officeitll picked today canadapostcorp fail	AHKru
previous tweet irl met awkwardness moment	AHKru
ramisms waiting main event ufc pretty	AHKru
making sauce meat balls thursday calabrisella	AHKru
love cheeky article morning good day alltesla ceo elon musk dings german carmakers apple forbes	AHKru
visitscotland count scotland hope move love canada xo	AHKru
going celeb shoutout respective wizard takes care laser waxing vmas amold	AHKru
behaviour holding backgal bf bf relax cue atomic bomb sunday funday	AHKru
long weekend rolling office friday	AHKru
buzzfeed reasons forced work retail day times	AHKru
nb visiting comiccon enjoy	AHKru
canada canadian thofjuly fireworks neighbours birthday morefireworksplease	AHKru
happy canada day canucks abroad	AHKru
chromebook chromebook question feedback	AHKru
bschweinsteiger euro geoger	AHKru
loving wattpad blackberry nerd	AHKru
ugh love nerding hard core ces vegas bring gadgets	AHKru
hey mindykaling fyi tuesday renamed minday equally awesome bff meghanrocca foxmindyproject happy minday folks	AHKru
love steam head postworkout feel metahuman theflash eddykayla chilly	AHKru
googleinbox basically version blackberry hub love hub intrigued wow google	AHKru
meganoid good night skum lolz yup going forget	AHKru
mediaobsessed question day happened santiago fnl	AHKru
eddykayla meghanrocca oooh spread good word dear	AHKru
happy passport day teamblackberry ready folks beaut blackberry	AHKru
nordstrom preorders trouble ya	AHKru
lost mind kruschack haus happy best birthday big played boys ger worldcup earnedit	AHKru
day good luck geniebouchard happy independence day usa dfbteamen worldcup	AHKru
eddykayla fun facts	AHKru
alizalicht promise simplepleasures	AHKru
wow drmayaangelou angelou life gift	AHKru
cest bon gohabsgo	AHKru
hey twittercanada sweet twitter bird boots kids clarksshoes cute	AHKru
eddykayla meghanrocca fpjj	AHKru
fyi rocking red mani today great minds	AHKru
absolutely idea himym care cleareyesfullheartscantlose	AHKru
valar morghulis spring gameofthrones	AHKru
laineygossip checked gwyneth gems enjoy	AHKru
nymag great article cityvillage proudly called timeochwheeshtgetoanwaeit edinburgh	AHKru
courtyforrest clare licking lipstwitching cool teeth filed ouff	AHKru
price cest bon quality hustle good day soo neighbours gocanadago cdnolympicteam	AHKru
building dead zones cell service teamcanada plays cruel uncanadian contractors	AHKru
dkny renamed hstl synonymous crazy hustle respect nyfw	AHKru
opening ceremonies alllrriiight truth aint party canadian party vancouver better vibe	AHKru
bruno mars effort chili peppers throw sb	AHKru
dkny wow scared death wet hair dry stage ditto passmemyproducts	AHKru
admittedly scaredy cat devilbaby keeled laughter repeat devilsbabyattack	AHKru
historypics johnny cash folsom prison years ago today photo jim marshall awesome	AHKru
dare jenniferlawrence dior fit good good goldenglobes	AHKru
dkny dear people respond email annoying truth	AHKru
alliwantforchristmas melon en route xoxoxo happyzizi	AHKru
whoa missed happy thanksgiving american family friends canuck abroad baci italia	AHKru
happy monday lot cover days italia wednesday happy lady	AHKru
hankering mrsub canuck abroad hands	AHKru
best gal sends youtube clip reddit brighten tuesday afternoon hustle awesome	AHKru
kw bursting wtalent action fervent blackberry supporter good friday read	AHKru
hey blackberry beauty caught eye vodafone love cancon uk blackberrybychoice	AHKru
happy canadian thanksgiving melindatravis expat abroad hugs kiddies	AHKru
hey dkny image best describes pr girl height busy lol great day	AHKru
alizalicht congratulations happy preorder	AHKru
comunque anni differenza di eta ho ancora ammiro mia zia como se fossi una ragazzinati amo zia anna xo	AHKru
dkny ceoj blackberryi bigger battery definitely handy week nyfw brewed coffee	AHKru
eddykayla lol twitter mdear	AHKru
coachkhamilton nanni hope hooking ginettis ride	AHKru
love hahahahaha everyday language longer corrects haha hahanot life	AHKru
bbmattk batman quality mystique	AHKru
decision hello firstbb tweet	AHKru
great read mobilesyrup definitely source things mobile	AHKru
love idea great blackberryworld gift cards existed	AHKru
mediaobsessed scuse quadcore solid qualcomm snapdragon dualcore krait proon par wthe androids solid starting point	AHKru
hear beyonce coming quarter turn things ers bey qb	AHKru
blackberry people successful	AHKru
apple call iphone puzzle piece manufacturers slapping	AHKru
official blizzard season dq kind isitspringyet	AHKru
border towns institute canadian holidays cmon canamerica	AHKru
camouflage couple assume going check moore draining garage	AHKru
elusivebalance confirm siberia	AHKru
sight felix insane	AHKru
kinda loving red chianti dry white risotto risotto pink	AHKru
meghanrocca dear rocca yessss xo dm availability darling	AHKru
maggieyepes bbm bbm bbm	AHKru
aliceluong congratulations alice	AHKru
aliceluong ha beast	AHKru
everyday include mayer hawthorne nowplaying	AHKru
hot today hoowee	AHKru
call spade spade lancearmstrong usada	AHKru
second previous tweet baby cuz baby mia xoxoxo	AHKru
teohalbert maggieyepes yankees	AHKru
birthday canada love game footylife canada olympics	AHKru
south africa mount playedwatched soccer life olympic commentary	AHKru
vajayme phone tag	AHKru
vajayme happy tweet hope ya	AHKru
excited doubts return love single settle break hsuniform lol	AHKru
pinner soo knew soo ahead curve wour lingo mint lol soospeak	AHKru
risveglia italia euro	AHKru
awkward afternoon kruschack house germany italy playing	AHKru
thankfully surprise sandusky guilty counts	AHKru
excited dark knight july latest trailer	AHKru
massive congratulations lakings jordannolan good soo player holding cup	AHKru
style jewellery neckline attitude	AHKru
gokingsgo nhl hoping dustin brown gang bring cup cali tonight	AHKru
lots injuries reported staple teams reping euro wonder team will peak time days	AHKru
dearest teslamay twitter finally	AHKru
dear hbo allowing precious extra minutes gameofthrones finish spectacular season wait	AHKru
happy memorial day friends family neighbors quicky shoutout teohalbert melindatravis	AHKru
sweet summer heat canada enjoy	AHKru
happy thursday tweeps gangstersquad awesome check trailer	AHKru
twitter feed blowing wbbwc tweets love feel bbtweeps	AHKru
love campaign pg great tie wmothers day coming olympics	AHKru
jbkruschack worth bro knockem dead	AHKru
happybirthdaydavid promo prometheus good enjoy creeptastic	AHKru
feel tom cruise ghost protocol walking wind sandstorm toronto	AHKru
love playoffs good nhl	AHKru
interesting article theguardianuk startups big buyout	AHKru
isragana omg excitement building	AHKru
enjoyed piece minutes sergio marchionne ceo chrysler group fiat spa brilliant	AHKru
gorgeous day spring np smashing pumpkins good enjoy	AHKru
great afternoon gameofthrones exhibition hbo lightbox isragana friends	AHKru
loving bebold commercials checkem great start week bold	AHKru
salwairiarte great view sally	AHKru
listening rosanna toto iceberg radio cool going ham style	AHKru
mroccadesign congrats matt best luck biz meghanrocca good pr	AHKru
andybarron pop cherry glory tlcs virgin diaries	AHKru
majorlazer pauly lazerfied amazing	AHKru
hours travel time heavy app usage blackberry battery cruising full boom	AHKru
morning tweeps gem globe enjoy asaunders roger martin defying rim critics globeandmail	AHKru
great reads nytimes amyjomartin billion woman purpose ladies	AHKru
california dreamin thursday afternoon	AHKru
meghanrocca meg classy ya lady	AHKru
gorgeous day toronto kind phantogram afternoon good	AHKru
isragana aliceluong martinkay vernetteeugene market bc genius	AHKru
will will best friend	AHKru
best luck thorsten heins teamblackberry	AHKru
coachkhamilton happy birthday ham	AHKru
game thrones season sneak peak promo hbo	AHKru
kaymichl lol bbm evangelist	AHKru
night town split morning bright early pleasure hanging wmy cuz dianamedaglia	AHKru
billwhish horror waiting passport office practicum	AHKru
mediaobsessed um i win	AHKru
happy year good xoxo	AHKru
enjoying evening mariorocchetta good friends facebook sucks	AHKru
great christmas eve kruschack haus family lots love merry christmas xoxo	AHKru
writer christopherhitchens vanityfair article	AHKru
bagging deflowering latex protectiongood morning best slide ppt presentation fyi talking bananas ppl	AHKru
jbkruschack congratulations jon	AHKru
fosterthepeople video color walls weekend started enjoy	AHKru
hey ticha twitter tweet	AHKru
hey tweeps friend jimmys band kalle mattesons latest video muchmusic check	AHKru
hear skrillex feel shouldve featured skins	AHKru
branding junkies good article stuart elliott nytimes	AHKru
going overtime boy geter pens nhl	AHKru
mariorocchetta coffee winners	AHKru
mariorocchetta good thing youtube channel blow lol	AHKru
killing library calvin harris music going coffee lots	AHKru
reason cats bad ass fat oskar kill eat cats wgreat ease	AHKru
bbmattk ya mutha fome	AHKru
coachkhamilton congrats hammy	AHKru
sitting hour stuffy class wa head cold cut head	AHKru
curtoneil wow win soo weddings	AHKru
happiest birthday friend mariorocchetta	AHKru
markpgibson called hipster today definitely funniest things happened today	AHKru
risk danger opportunity combined ham	AHKru
angelicize shouldve highfived lol	AHKru
woohoo booked flight christmas porterairlines sweet deal flights booking quick people	AHKru
mac kids definitely rolled class wa bold touch morning muahaha	AHKru
kruschack haus kitchener thanksgiving weekend feels good	AHKru
amandaknox case previous tweet	AHKru
curtoneil going hide library summer time	AHKru
agree spellinggrammar mistakes harder people	AHKru
happy celebrate milestones good friends love thankful	AHKru
interesting insight alkesh shah bnntv rim chief story teller	AHKru
mariorocchetta disappointed going yr event time awesome	AHKru
yorkville full pretty people tonight bun pretty mine snap snap	AHKru
mariorocchetta love weird soo thing	AHKru
kilometres help checking ssm local sootoday soo	AHKru
kaymichl splendid learned year sudz talk bbm	AHKru
bbmattk congrats matt	AHKru
blackberrynewscrackberry motion blackberry honored commemorative stamps canada coolio	AHKru
mariorocchetta sweetspicy thai maple bbq	AHKru
finished months vanityfair great issue voguemagazine age issue evening	AHKru
ericalotman erica hello cousin follower lol hope family vancouver	AHKru
mariorocchetta the form starbucks lol	AHKru
amandarubin trump card tune awesomeness	AHKru
happy fathers day dad big happy fathers day bro bbmattk lots love pops	AHKru
robynkonichiwa video call girlfriend love nv ipg ss	AHKru
mediaobsessed hate glee fail	AHKru
mediaobsessed singyshih sookies bridesmaids completely unaware dang going to asap	AHKru
stephiebow love true	AHKru
amy poehler will arnett yay metgala	AHKru
cmon canucks series bed nhl	AHKru
exhale nhl canucks	AHKru
early ffbut follow grand dames sportsbiz melindatravis katrinakaye hmcharles blog	AHKru
gohabsgo woooooooooooo nhl	AHKru
pittsburgh excellent work fleury nhl playoffs woo	AHKru
rip sidney lumet sad day film lovers	AHKru
gavinslate american apparel	AHKru
amandarubin liveprofile ping chat eh work bugs	AHKru
mediaobsessed kidding brutal watched shamefully	AHKru
bon temps summer sad itchin trip louisiana trueblood	AHKru
big girls big diamonds dame elizabeth taylor	AHKru
day spring snow reallycan summer canada	AHKru
hot mess bachelor	AHKru
watching bachelor caps tampa bay judgement lol	AHKru
blackberry great loved spots thx sharing	AHKru
loving trade center commercials tsn	AHKru
mariorocchetta works charm coldfx	AHKru
amandagravel vote red velvet	AHKru
wow tyra collette long congrats adrianne palicki	AHKru
time buy underarmour stock nfl	AHKru
love thisblackberry lovers watch blackberrynews heads wait super apps	AHKru
time speak hs kids definitely going arrive birth sack la lady gaga	AHKru
wow long mike fisher nashvillethx carrie underwoodbest luck sens solid rebuild	AHKru
thought bring tv remote morning coffee fail	AHKru
halftime fell flat fail nfl	AHKru
aaron rogers resembles supersized steve carrell weird nfl	AHKru
mark zuckerberg wjesse eisenberg snl kinds great great episode	AHKru
amandarubin long kw will gta lol	AHKru
ricky gervaiss laugh hilarious piersmorgan	AHKru
love deniro starting sound rambling man	AHKru
ricob agreed kick	AHKru
popsugar great fresh clean lines love uploads smooth big fan	AHKru
kassian nice wjhc russia	AHKru
mandydennison mandy great feeling	AHKru
canada boys worldjuniors	AHKru
follow ryanpyette juniors updates info great guy great writer stuff	AHKru
unimpressed barbara walters fascinating list	AHKru
mariorocchetta negative hot chocolate brownies	AHKru
early day running man jpzrpczfze	AHKru
awesome marketing campaign nissan juke check	AHKru
amandarubin public humiliation teamlets find himill work towncrier magic loser	AHKru
amandarubin nunchuk power michelangelo	AHKru
savvy prbiz ladies melindatravis hmcharles katrinakaye	AHKru
check video blackberry playbook official demo video commercal coming youtube	AHKru
ontarians time today vote	AHKru
trailer released fighter starring mark wahlberg christian bale forward	AHKru
dianamedaglia will excited things auntie	AHKru
mtl blew game win pittsburgh ouff gohabsgo	AHKru
montreal toronto habs	AHKru
nhl preseason time year	AHKru
feel watching saved bell	AHKru
melissacugliett curve mel trackpad wins	AHKru
littlecitymusic great band great people homegrown big things	AHKru
amandarubin rubin tellem	AHKru
point life piece couture lot	AHKru
feelin good wedding weekend ahead woohoo summer time cottage wedding lake superior horseshoe bay wrong	AHKru
absolutely loving vogue september issue amanda happy lady	AHKru
degrees refreshing start week	AHKru
blowin popsicle stand days fist pumps	AHKru
missing worldcup buzz	AHKru
today birthday girl	AHKru
canada guard bears guard dogs bears good thursday	AHKru
happy birthday bro jonathan hope great	AHKru
amandarubin heard alright reading	AHKru
mediaobsessed enjoy play sean paul feel	AHKru
amandagravel second figure move forward gotta moving forward	AHKru
curtoneil true pizza sooza	AHKru
will people learn highoctane country music	AHKru
biking running intervals amandas legs jelly good jelly	AHKru
close homemelindatravis mill acts kindness mateencleaves works raise literacy rate flint mi	AHKru
pm monday afternoon making sauce dinner tonight catch	AHKru
love announcer puyol regarded intelligent players yoga esp worldcup	AHKru
professional athleteany public figure starts referring person amanda tunes outoff lame	AHKru
ger loses spain loses danes shunned puyol cut damn hair nhl playoffs	AHKru
condolences probert family soo greyhound nhl enforcer bob probert dies	AHKru
mmm love good argentine breakfast ger worldcup	AHKru
melindatravis happy canada day beautiful lake superior sopressata sliced ready eaten	AHKru
congratulations david villa goal la liga player esp	AHKru
wonder better play maker kaka gonna worldcup brazil	AHKru
recordus players draftedso calikaty perry remix california boys undeniable ohuhohuhohlol	AHKru
half italian calabrese cut knockout svk german bring brits worldcup	AHKru
heck earthquake sault ste marie	AHKru
dear azzurriyou playing grass water diving jumping spring board will win play game baci	AHKru
jaro move disappointing hey trade nhl canadiens	AHKru
snazzy cleats worldcup making plain adidas reds lame	AHKru
mexico wowd arenathink germany better tho german engineering worldcup	AHKru
big game tonight playoff fanscan captain serious team dod flyers playoff tombstonego hawks goin	AHKru
true blood cup hurdling love june	AHKru
mediaobsessed disappear cover darkness disappear couple years joke	AHKru
will habs pull clutch win tonight habs suck	AHKru
passthegin vino feel better stretching tucked glass	AHKru
mediaobsessed to angry place today day	AHKru
cinderella cinderella habs cinderelli	AHKru
love playoffs regular season compare play win	AHKru
forward tonights game pingus mtl will halak kid	AHKru
hot tubs hot	AHKru
lot bad tv goodbad tv bad bad	AHKru
mediaobsessed btw happy birthday taylor signed epic hotness long dillon days	AHKru
easter chocolate face bloat going	AHKru
june lookin good cup true blood aye aye aye	AHKru
mid questioning life wrong	AHKru
voted photo check	AHKru
love fuck space	ATMXO_
police issued amber alert car carrying threemonthold baby boy stolen albion road highway area	ATMXO_
hansinidesilva man rmr download tracks	ATMXO_
hate ppl like eraser clean pretty times	ATMXO_
tara bed mother fucking day	ATMXO_
markpersaud close walk	ATMXO_
ahhhhhhhh heart soulllll literally crying deal	ATMXO_
spanday waiting launch party correct set faults paws will	ATMXO_
baby girl living life feeling	ATMXO_
devikathakur lucky birthdays nice mines march	ATMXO_
devikathakur wanna transfer files cpu thorough search	ATMXO_
looked baby sister realized years oldlike three year ago	ATMXO_
devikathakur search files check downloads hidden files asap	ATMXO_
jesus low key computer geek rid stupid laptop of viruses	ATMXO_
anils rare momentsthey week lol	ATMXO_
farihah dory tbt times body parts stuck lmaooo buddy	ATMXO_
current challenges unresolved today aries	ATMXO_
inclined best led aries	ATMXO_
exactly you beelin aries	ATMXO_
excited putting day hard work today aries	ATMXO_
intuition tune today sho aries	ATMXO_
expressing feelings easiest course action aries	ATMXO_
events realize today aries	ATMXO_
brawl rival drug gangs overcrowded penitentiary northern mexico turned riot thursday	ATMXO_
braedenadhd bruh idea weird open eyes follow lmao	ATMXO_
happy worldnutelladay guys lol	ATMXO_
share emotional today filtering ou aries	ATMXO_
natural tendency blown prop aries	ATMXO_
solo rider till die cuz life	ATMXO_
choose choose lol vscocam ialwaysforgettotakeprepartypics	ATMXO_
strength convictions aries	ATMXO_
kitinaa happen lol	ATMXO_
shit cheeeeeeeeses fucking soul holy fucking shit	ATMXO_
drive school bus	ATMXO_
mehulvisavadia lmao fob	ATMXO_
sucks friends college lol	ATMXO_
lmao life grade iwassohit tb taraflirtz thatwaslife	ATMXO_
cute boys walking mall jummah clothes	ATMXO_
withholding thoughts today sensible strategy ev aries	ATMXO_
listening voice reason easy today relations aries	ATMXO_
cryyyyyyyyyyying holyyyyy shit	ATMXO_
camera roll consists pictures quotes place mind	ATMXO_
natural lack patience undoing fortunat aries	ATMXO_
sharing details busy calendar family frie aries	ATMXO_
total control circumstances work today aries	ATMXO_
encouraging direct action today st aries	ATMXO_
alextheillest class schupid	ATMXO_
options today complicate efforts decide aries	ATMXO_
tempted inflate trivial incident major aries	ATMXO_
sensitive probabl aries	ATMXO_
you accomplish choose today aries	ATMXO_
jaadegoee ik ik girl lol	ATMXO_
events happening reason today befud aries	ATMXO_
impulsive behavior bring you today espe aries	ATMXO_
ariellenancoo will future nitty	ATMXO_
chance logical today aries	ATMXO_
years ya fav bitch	ATMXO_
xxshaneeza birthdays ya ofc turn fuck bby	ATMXO_
heard bitcj lmao baybeehmiina jasmineem	ATMXO_
baybeehmiina easy payments	ATMXO_
acutely aware missing aries	ATMXO_
wizardly day overflowing potential magic aries	ATMXO_
twelveofspades hey aware plan worshipping wise thoughts coughcough rapist	ATMXO_
exercise rights canada asses closest voting station today elections electioncanada	ATMXO_
carmennirvana vote station fam	ATMXO_
freedom trade fo aries	ATMXO_
feeling sexual healing	ATMXO_
birdtwinkle friends reached levels creepy	ATMXO_
sairahassan chill hw	ATMXO_
shouldve start foolish heart	ATMXO_
fucking kidding brutally disgusting levels	ATMXO_
better feeling happy investor purchaser dreammaker development altonawoods pickering	dreamakerrealty
dream maker ventures social venture play legal socialentrepreneur socialenterprise venture	dreamakerrealty
invest fundamentals speculations	dreamakerrealty
south view floor floors dream residences yorkdale dream yorkdalestyle realestate	dreamakerrealty
game dream residences yorkdale yorkdaledreammaker	dreamakerrealty
happy holidays dreammaker team	dreamakerrealty
concrete drilling preparationdream residences yorkdale youtube	dreamakerrealty
branding coming soonfor dreammaker team teaserdontjustbeanagentbeadreammaker	dreamakerrealty
condo crash video covers demographic trends will support condo market long term housing	dreamakerrealty
youtube video custom build lego simple farm house cc	dreamakerrealty
forwardgreat music great	dreamakerrealty
investors ready tune	dreamakerrealty
nigerianfull house physicians dentists royal york hotelgreat image community	dreamakerrealty
great meeting team kirkorworking finalizing floorplanslove gameyorkdale dmd dreamresidences	dreamakerrealty
game easyonly built grindteambuilding yorkdale dmdplanningwhileotherssleepin	dreamakerrealty
great meeting today african canadian heritage association yrs strong nice values generationalwealth dmd	dreamakerrealty
forward rolling brand bed units located downtownclosing couple months guarantee tenants kvalue	dreamakerrealty
hugo boss dresses success nigeria	dreamakerrealty
top viewed linkedin profiles	dreamakerrealty
great articlerepresents fundamentals dreammaker team talks realestate	dreamakerrealty
bmo sees housing market moderating interesting points madeas stick hype simple	dreamakerrealty
media battles goodbad news focus fundamentals yorkdale	dreamakerrealty
standing inventory gta bedroom bedroom den units smaller units selling fast	dreamakerrealty
love dream maker corporationnew relationships formed ambassadorsstart localend globaldmr dfh dmc	dreamakerrealty
day filming dreammakerson set hottest waterfront project worknplay showbiz dmr	dreamakerrealty
chair bbpa scholarship fund excellent work board staff scholarships	dreamakerrealty
tridel market based speculation understand will market dmr	dreamakerrealty
loving nycbut bout growth opportunities undervalued	dreamakerrealty
jmerciecafit great bro	dreamakerrealty
woke thx god day asked ready launch dream maker developmentlocation perfect price	dreamakerrealty
globebusiness canada lucky options economy slows bufferwill	dreamakerrealty
game tridel york	dreamakerrealty
crashes based fundamentals cracks crashes based media involvement canada	dreamakerrealty
foreign minister canada traveling nigeriavery interesting opportunities starting hit mainstream market	dreamakerrealty
jude dreammaker set tv showstay tune pics pilot dmr	dreamakerrealty
good job cap bclosing rentals hrsthis game easy today reporter cap playing game dmr	dreamakerrealty
start week great meetings community leaders tv producers ryerson hear president coo riocan gzz lov	dreamakerrealty
talking dreammaker commercial game preconstruction commercial yr leases banks kingdommovements	dreamakerrealty
companiesbrands equal massive potential montreal project	dreamakerrealty
motivation nightgreat dinner ceo dundee wealths housebar raised dmrdfh	dreamakerrealty
great time corey rogers tv great topics educationjob market real estate mrk	dreamakerrealty
experience prepared thatlooking forward growing team nigeria thxgod dmrtakeover dmrnija	dreamakerrealty
god willingthe dreammaker team change real estate years	dreamakerrealty
game everyonethats will lead will followmajority will watchcome ready work dmr dfh hope	dreamakerrealty
mid ks ks studiosgood thing bedrooms downtown gzzzz dmr topotential dfh	dreamakerrealty
hrs dmr chilling queen westand drake hotel love cashback congrats team	dreamakerrealty
investors goodbad dreammakers pushing decade makingvertical integration real estate divisions dm	dreamakerrealty
today dream makers nyc grindand signing deals free cruisedmr workpleasure dream maker	dreamakerrealty
realized todaythere places summer will motivated sadto ny grindlove	dreamakerrealty
soam chilling princess watchn miaoo developer jb msg boat sale moves mimicogzz hard rest	dreamakerrealty
big surprise toronto bubble going growth immigration lol	dreamakerrealty
evening started dmr annual barbados charity balllooks big turn	dreamakerrealty
love towhich boat hold meetings today workpleasure dreammaker	dreamakerrealty
dream day eventsacross city st speakn sipo warlene dickinson ceo venture communications cbc dragons den	dreamakerrealty
ja tonow brick sessionwhos golf tomorrow morning heard weather great	dreamakerrealty
exclusive ground breaking press conf start media builders dreammaker game	dreamakerrealty
congrats clients won bidding war downtown king st story bed parking dream maker dol foot unit wow	dreamakerrealty
karlynpercil will ityea nice great great work forward big bbpa event sat	dreamakerrealty
day speaking engagement set dmrdfh empowerment tour moving movement building generational wealth	dreamakerrealty
buzzbuzzhome digging oversized balconies jade waterfront condos toronto great project investors happy	dreamakerrealty
dmrdfh focus caught greed hype will crash great article	dreamakerrealty
life buying selling bricksfinished waterfrontsign sale loft liberty village sold daysspring shopping	dreamakerrealty
badbout week previp unit mine left floors higherlooks winner dmr	dreamakerrealty
game gonna ugly manwow lebron laughn	dreamakerrealty
globeandmail globebusiness forget retirement canada time	dreamakerrealty
bildgta pmabrethour canada leading growth rate	dreamakerrealty
exclusive project units located forest hill yorkville annex stories high	dreamakerrealty
great bio tv ascent money evolution money lending banks led current crisis	dreamakerrealty
industry changing movements dmr dfhstay tunewe rock gamenow find golf course open vaughn lol	dreamakerrealty
bam bam bam team meetinglol real estate wealth managementis knowlol	dreamakerrealty
percent sound mortgage maint life mindowntown buy upside man love game dreamteam blessed	dreamakerrealty
love itwe making dealsthe team bright earlyno breaks weekends	dreamakerrealty
love project type google example casa vip agentslolol vip lol	dreamakerrealty
earlybnntv condo market selling chinese marketcant wait hear	dreamakerrealty
ceo lanterra saysmarket great bnninteresting	dreamakerrealty
great callwe launch history downtown toin equity game dfh standard	dreamakerrealty
joelosteenwhen focus gods promises problems notice thoughts will healthier filled peace	dreamakerrealty
real estate brokerage energy brokerage black black benz clean black suit lv shoesam sayn	dreamakerrealty
housing crash canada bmovery interesting people will understand game media plays realestate	dreamakerrealty
dreammakers againqueen west bed wasroom range credit yess perrented days	dreamakerrealty
creflodollar hope god going faith god live faith	dreamakerrealty
forward speaking north albion ci for marcia browns mens group good times	dreamakerrealty
going global goal day tonight confirmation lord	dreamakerrealty
bank canada expects economy grow percent fourth quarter previous estimates percentback fouth info gzzz	dreamakerrealty
feeling good soccer games mdot st placegood seasondaughter watched daddy play soccer st time	dreamakerrealty
selling la hgtv good movies today lol	dreamakerrealty
buzzbuzzhome powerful data love itmore reason demand will continue	dreamakerrealty
realestatefeeds real estate market baby boomers condos reportseniors will account	dreamakerrealty
nice raptorsclose game	dreamakerrealty
dreamteam win remixwho track lol	dreamakerrealty
dream party going wella lil break listen great musicgreat times	dreamakerrealty
reasons canada changes hurt buyers short term protect economy long term	dreamakerrealty
dreamfund dreamfundlove itgod givenwe stoppedso point tryingjoin movement watch side	dreamakerrealty
mediahuddle buzz excellent work media space great job eventcant wait	dreamakerrealty
response dream project dream teamhas nuts units emailsthis demand solid deals	dreamakerrealty
businessinsider yields higher europe german bond auction bad belgium worsening futures falling	dreamakerrealty
presentation sweet thx godnow acce business forum business crossover canada chinabuilding relationships love	dreamakerrealty
global problemslook valuebuying avg sqfeet downtown toronto valuelow rates security	dreamakerrealty
chilling box seatswith managementclose game quarter power	dreamakerrealty
toronto board trade awardswin losei teampartnersclients love support wanna win lol	dreamakerrealty
wow big day wify bdaylova yathen speaking engagements placesthen miaoooooowe live	dreamakerrealty
rental market heating toodreamfund will units ready lease control game	dreamakerrealty
bbpa changes lives history national scholarship presentation granted class students	dreamakerrealty
started bedroom units queen westnow lefta lot bedroom area selling kanother dreamfund	dreamakerrealty
seasons tickets only games season starts soondreamfund tix st game msg tix	dreamakerrealty
family clients love supportlets big prize nov	dreamakerrealty
question ready answer god ready	dreamakerrealty
kaylas real estate projectnice tridel project hope	dreamakerrealty
gonna fast week tridel downtown queenwest projects land projectred carpet invite tiff launch fun week	dreamakerrealty
working deals downtown buy bedroomor sq feet area cost sq wow	dreamakerrealty
dollar real estate filmingstarting dream teamso ideas opportunitiesnot time	dreamakerrealty
stay tune land development projects percent unit opportunity percent	dreamakerrealty
acres land partnersnumbers good dream fund development deal	dreamakerrealty
omg dream fund nation wide stay tune	dreamakerrealty
extreme workout session starts today prepare golfbeach vacation barbadoslol	dreamakerrealty
nice day daughterbut time close king lease water park leasedream team game lock	dreamakerrealty
excited watch cnbc titans jack welch	dreamakerrealty
long day hr shift dream teamwell worth itreal estate day everydaydream fund	dreamakerrealty
game changerthe key game accessand dream fund itthe street ready	dreamakerrealty
big weekfor dream teambaybloor special project stay tune	dreamakerrealty
cselley complete unpainted drywall	MacSweeneyG
jonkay happening days	MacSweeneyG
stephentaylor wrong song al green stay	MacSweeneyG
christ horrendous nightmare describe	MacSweeneyG
ladies gentlemen call prof justice system yr charged yr offence	MacSweeneyG
bet click bait	MacSweeneyG
graciestyle good terms point joining confederation	MacSweeneyG
pnpcbc carpnews stance television	MacSweeneyG
journodale cauliflower course luxury veg sold season luxury relative deprivation create	MacSweeneyG
thejohnhastings yukyuksgta brother brah	MacSweeneyG
jandrewpotter dougsaunders pfu compare labrador city	MacSweeneyG
emmmacfarlane meeting ottawa tame comparison laurapayton talking peejloewen markdjarvis	MacSweeneyG
hate disappear exp hate respond dog whistle	MacSweeneyG
msbriggshdsb anonymity fully agree exercise freedom speech challenging	MacSweeneyG
continue life separated state find dumpster	MacSweeneyG
perreaux father inlaw bison yrs ago tree fence	MacSweeneyG
guy blowup doll twitter pic realdarrencohen	MacSweeneyG
state nature solitary poor nasty brutish short hobbes dimocksusan moalhakim ethicsblogger	MacSweeneyG
nspector kenny practising catholic explained time	MacSweeneyG
mikeshaikh enjoyed ottawacitizen piece thought ian greene	MacSweeneyG
squidpope timhudak law course	MacSweeneyG
realdarrencohen extol virtues separation church state moalhakim	MacSweeneyG
terryglavin mattgurney rowancaister joshuahind case duty ally clear attack	MacSweeneyG
illinoisrider consume unfresh product risk sick analogy	MacSweeneyG
illinoisrider kind hard criticism seriously upfront you delete tweets	MacSweeneyG
illinoisrider stefcoinc carlsonlabs goedomega nope obj erroneous tweet friend failure man integrity	MacSweeneyG
illinoisrider stefcoinc ignorance claiming chemist	MacSweeneyG
healthcanada drerichoskins janephilpott meganogilvie tomblackwellnp picardonhealth cambridge journals online	MacSweeneyG
shaming ashley madison clients suspect blush case	MacSweeneyG
cmaconthehill laurapayton good video expect trudeau cabinet	MacSweeneyG
spartanvtyranny going talk	MacSweeneyG
wrong afghanistan ohsheri mattgurney russilwvong fullcomment	MacSweeneyG
ohsheri mattgurney russilwvong fullcomment boots ground helping kurdsrefugees	MacSweeneyG
emmmacfarlane constitutional issue obviouslythemainissue	MacSweeneyG
year publicity stunt hope civic health country	MacSweeneyG
hilarious hypocritical thing read	MacSweeneyG
aaronwherry tonyclementcpc checked pmharper to rosiebarton today	MacSweeneyG
will write dissertation doubt dgardner	MacSweeneyG
proudgrannycdn suelib bonkwazi robsilver iwouldnt call pmsh tyrant concern majority fear curb rights	MacSweeneyG
nspector strategy mandate set election bargaining team moving efficiently	MacSweeneyG
emmmacfarlane rosiebarton pnpcbc doubt will left	MacSweeneyG
dimocksusan article find frustratingly interesting	MacSweeneyG
suppose depends content comments politically damaging assume	MacSweeneyG
cmaconthehill find interest	MacSweeneyG
paulisci supply step desperate step	MacSweeneyG
pee pretended wee wee	MacSweeneyG
nspector considering multiple factors consideration	MacSweeneyG
bit critical thinking diehards elevate discussion	MacSweeneyG
picardonhealth mdentandt warrenreports epaultaylor quick talk paying sex elnx	MacSweeneyG
specific ndp claim workers will directly raise supportable evidence	MacSweeneyG
katiesimpsonctv find copy	MacSweeneyG
tired pmharper years older justintrudeau pm	MacSweeneyG
cmaconthehill house house cormac	MacSweeneyG
torontostar olympics built facilities pan second bang buck	MacSweeneyG
pluto lovingest celestial body solar system	MacSweeneyG
start search kansas place	MacSweeneyG
laurapayton pass bean game cook book	MacSweeneyG
stuartinthecage paoconnell gavmac suppose create bit tension family	MacSweeneyG
election going fun forward debates	MacSweeneyG
robsilver justinling liberal democratic weekly hand	MacSweeneyG
emmmacfarlane justinling markdjarvis currently influenced pmo doubt	MacSweeneyG
emmmacfarlane bothered sections applies	MacSweeneyG
realdarrencohen nba fan	MacSweeneyG
resolved fact twitter philosophical debate equivalent talking wall whilst hitting head wall	MacSweeneyG
leftardhockyguy actiongeologist concern state tells you fear offence	MacSweeneyG
laurapayton cmaconthehill yell	MacSweeneyG
cselley kady debate fishing vessel withstand sea sick honesty	MacSweeneyG
emmmacfarlane davestubbs leafs banning toss sweaters	MacSweeneyG
frustrating read bc reality situation	MacSweeneyG
doom gloom economic front bode governing party generally suspect	MacSweeneyG
watch videosinkhole swallows spits passenger bus brazil	MacSweeneyG
isis destroy ancient site iraq	MacSweeneyG
mrsinisterlefty laurapayton harrisauthor course viewership political diversity point	MacSweeneyG
mrsinisterlefty laurapayton jimbostanford assuming include diversity views business	MacSweeneyG
torontostar mybeerstore buy beer beerstoreboycott blackmailing customers monopoly disgusting	MacSweeneyG
robsilver flatearthorg start running race start toronto heading west days	MacSweeneyG
chastonb fareestweetable ctvmercedes	MacSweeneyG
fareestweetable ctvmercedes mandatory voting start surely	MacSweeneyG
shauntanakays greater representation discussion discussion interaction interaction involvement	MacSweeneyG
ails leafs bit leadership icea guy carry team whip things	MacSweeneyG
robsilver questions answer wanti yr question terrified answer	MacSweeneyG
macsweeneyg laurapayton extensively yr applied ethics class today sparked interestingly discussion	MacSweeneyG
cmaconthehill dad reports service monday morning cook	MacSweeneyG
agmacdougall mansheleepoo leepoosheman shemanleepoo	MacSweeneyG
doug ford mayor officially sham james torontostar	MacSweeneyG
stefcoinc nickmalian good screen play chain scn play written twitter sunny sunday afternoon city	MacSweeneyG
michaelfaz happy birthday good sir hope filled sorts fun stuff	MacSweeneyG
medicaltweeter interest pivotalthr announces patent omega medicalfood vascazen obesity diabetes cardiovascular	MacSweeneyG
rob ford leave absence lawyer	MacSweeneyG
conservatives move fasttrack study fair elections senatelooks voter turnout will drop	MacSweeneyG
play guitar wanna band jam	MattSkiing
grave encounters sickkk	MattSkiing
strangest concept album aliens invade earth find coffee	MattSkiing
happy birthday cisky earth day	MattSkiing
haha osslt chirps year	MattSkiing
youtubeanderzel enter contest dude	MattSkiing
normal morning shoes coffee haircut flagged fraud royal bank	MattSkiing
ssvsnowsafety sunshinevillage sense	MattSkiing
weird shit tired	MattSkiing
teachers preparing university treat university students	MattSkiing
full tilts expensive	MattSkiing
tims morning literally	MattSkiing
egamingbets chance ldlc win poor dsmax lol	MattSkiing
yay month winter	MattSkiing
bell internet terrible	MattSkiing
cisky lord ringshobbit read	MattSkiing
photos snow cool stuff	MattSkiing
hope os tomorrow	MattSkiing
entered win bunch minecraft loot jinx minesplosion	MattSkiing
tony romo won suspendedhe beats	MattSkiing
guestwill good times chance	MattSkiing
guy skyrim nord	MattSkiing
skilefley newschoolers redbull hell	MattSkiing
sweet website live stream cup games fr	MattSkiing
day legendary warrior time hammer smash falskaar twitch	MattSkiing
going playon tournament weekend	MattSkiing
damn twitter profile update screws led zepplin header	MattSkiing
dang cleared gb ssd springcleaning	MattSkiing
haha fun time today	MattSkiing
acms awesome eric church unreal ericchurch flagaline acms	MattSkiing
wait march break shakenbake	MattSkiing
awesome time tonight jeepers creepers scared shit outta	MattSkiing
man week awesome going skiing tomorrow	MattSkiing
martinfleury find twitter	MattSkiing
movie memories twitter vizify	MattSkiing
torinwallace man hope will dew tour event	MattSkiing
hosting plugdj community	MattSkiing
djing couch plugdj playing led zeppelin lotta love	MattSkiing
lol rob ford	MattSkiing
mhykol hooray mhykol	MattSkiing
happened google alshdhadkjhawldafs	MattSkiing
therussky xjoshh dinnerbone alright	MattSkiing
week nfl bills	MattSkiing
minecraft snapshot time	MattSkiing
happy july muricans	MattSkiing
xd teachers eavesdrop	MattSkiing
xd pajama day today	MattSkiing
readin batman comics	MattSkiing
torinwallace mytp freeskiing practice runs	MattSkiing
yess short week	MattSkiing
solid day skiing	MattSkiing
excitedfor oba tommorow	MattSkiing
wait going skiing weekend thanksblizzard	MattSkiing
ipad today gb	MattSkiing
lol second power outage san fran year	MattSkiing
reason profile pic grainy uploaded	MattSkiing
exam review day works	MattSkiing
cnnshowbiz best director motion picture goldenglobe awarded ben affleck argo goldenglobes good movie	MattSkiing
lolll prez pass bill	MattSkiing
lol sister understand elf runes	MattSkiing
yess candy cane egg nogg good	MattSkiing
good luck charm people good luck wear bad luck charm people bad luck	MattSkiing
happy dad switched bell rogers rogersdoesntwork	MattSkiing
concert eddie vener sick comfortably numb	MattSkiing
gapergear thinks side rail jump	MattSkiing
nowplaying handrwitten gaslight anthem album	MattSkiing
loll help nhl	MattSkiing
speakers decent bass	MattSkiing
gordon wearing twilight bracelet	MattSkiing
will baby candy	MattSkiing
striploins staying project	MattSkiing
songsonshuffle magic power	MattSkiing
ifitwasuptome snowing rite	MattSkiing
ahh ears kill drums duriing lunch	MattSkiing
love share tweets twitter	MattSkiing
canadianprobz animals kind kisses canadianprobz holy cow	MattSkiing
confrence call striploins neat	MattSkiing
studied geo playing minecraft	MattSkiing
weirdest promoted tweet	MattSkiing
flint steel creation nether portals	MattSkiing
mac rumors ipad mini launch attracting shorter lines launch day	MattSkiing
xosamanthac la complex tv	MattSkiing
striploins lake louise opens november	MattSkiing
wonder tommorow will bring	MattSkiing
omg teacher forced kids drink radioactive milk	MattSkiing
thrundromon myt twitters better	MattSkiing
people quick judge	MattSkiing
omg hamilton awesome	MattSkiing
brought sign request racing street youtube great song	MattSkiing
braveselric cool trippp woahhhh	MattSkiing
woops tweet springsteen stoked hamilton	MattSkiing
canada deystroyed cup qs	MattSkiing
field trip niagra	MattSkiing
jakersgames good idea	MattSkiing
wow hours thirty minutes	MattSkiing
funny bitbook post pocket planes mac	MattSkiing
going argo tointe	MattSkiing
ughh hate wind	MattSkiing
hope picked play drums junior concert band zaga	MattSkiing
yaa great century rite 	MattSkiing
amacri buy caftetria	MattSkiing
omgfacts nerdiest sporst cheer mit cosine secant tangent sine learn haah	MattSkiing
second hardest becuz time	MattSkiing
yaay scored asisst	MattSkiing
freedlecoty people snows hahaha	MattSkiing
instant followbacl mattskiin teamfollowback	MattSkiing
tweetlikeagirl ommmgggg breathing air zayne niall	MattSkiing
random nose bleed	MattSkiing
samsung attacks iphone galaxy print ad digitaltrends hahah samsung stupid	MattSkiing
hahaha dads company switching blackberrys iphone	MattSkiing
mac rumors iphone reportedly launch pricing iphone the left iphone	MattSkiing
ppl cartloads stuff costco	MattSkiing
tom morello craziest things guitar	MattSkiing
ahh best weekend	MattSkiing
omgfactsthe cover neil young album silver gold game boy camera check itout lol	MattSkiing
hockeylife ya hate bad licker	MattSkiing
beats good guitar solo	MattSkiing
going indoor rock climbing today	MattSkiing
wait goto cjs	MattSkiing
lol west shoes ipod case bucks highway robbery rite	MattSkiing
woah australia tommrow afternoon	MattSkiing
epic watermelon fight today	MattSkiing
working saran wrap ball	MattSkiing
xgames going gnarly night photo uedalincoln xgames	MattSkiing
ahhh love profile pic	MattSkiing
will post pics grad facebook	MattSkiing
ohhhhh report cards today	MattSkiing
oommg groundhog watching play tennis minutes	MattSkiing
grad mass awesome	MattSkiing
ommgz mercedesbenz lamborghini parked nieghbours house	MattSkiing
omgfacts awarded person tipped forces whereabouts saddam husseins sons woaah	MattSkiing
omg queen hard play piano	MattSkiing
nice move italy	MattSkiing
happy fathers day	MattSkiing
walkthewire lifetime event	MattSkiing
playing soccer dying heat	MattSkiing
wiped elrics longboard	MattSkiing
iphone oddfuturetime software	MattSkiing
dad mite mercys talent	MattSkiing
weknowfacts england suicide illegal punishment kill death dafuq	MattSkiing
don cherry funny voice crack	MattSkiing
woooow tiger woods won	MattSkiing
wanna watch neil peart documenrty dads watching jays baseball games left rushfanprobs	MattSkiing
advertise follow acoutns	MattSkiing
woahtommorow june whathappened	MattSkiing
real greg heffley beat lot	MattSkiing
wooow snake ppl unfollowed	MattSkiing
gotta tweets june expect lot rando	MattSkiing
sweating playing catch	MattSkiing
key life lock broken	MattSkiing
watching percy jackson tweeting	MattSkiing
marlies calder cup finals	MattSkiing
great time guys phetunning supreme	MattSkiing
yougetpointsif puck net	MattSkiing
watching bage paint dry	MattSkiing
oddfuturetime ya mom cleaned stuff stings wil live	MattSkiing
government formspring account	MattSkiing
global news chopper	MattSkiing
ohmzapp profile bottom blocked	MattSkiing
confirmation amazing special	MattSkiing
love smoothie nasty tastes awesome	MattSkiing
cold basement warm	MattSkiing
great time dad biked mall national	MattSkiing
yeeeeeesssss dance met	MattSkiing
wwth random pics phone	MattSkiing
vimanala learned twist shout	MattSkiing
wooooah mike douglas replied	MattSkiing
morning tweeps playing drums actual track low wateva	MattSkiing
omgggg bobby brown tweeted	MattSkiing
lot randos metion twitter smh	MattSkiing
picked captain america tanked soldier jumped gernade turned dud save evry	MattSkiing
ssssstupid twitter ugh send tweeettttt	MattSkiing
eww connor mayard rando kid	MattSkiing
tweet cetain lyrics people will	MattSkiing
barrel roll press	MattSkiing
hope obsess weeks finals haha studentlife	Nounnno
tweet bismillah firsttweetforeverything	Nounnno
putting liberalparty internship application	RowanMMolloy
troyesivan tour dates pls	RowanMMolloy
bethanymarie thought tweet	RowanMMolloy
thedanforthmh troyesivan dates	RowanMMolloy
twitteradsau sydneymardigras anzau gaynz	RowanMMolloy
doddleoddle dodie good love jazzy songs	RowanMMolloy
troyesivan detroit canada	RowanMMolloy
troyestripod troyesivan yeah going hours tomorrow	RowanMMolloy
troyetoshow troyestripod cancelled	RowanMMolloy
troyesivan feel better	RowanMMolloy
annoyingfeminis to mutts	RowanMMolloy
troyesivan staring light def best watch youthvideo	RowanMMolloy
kiss devobrown troyesivan instagram hmv	RowanMMolloy
troyesivan colour nails friday	RowanMMolloy
sb coldplay playing popular songs	RowanMMolloy
corradocoia happy saskiavanell place join toronto fall	RowanMMolloy
johngreen french llama years	RowanMMolloy
mrwoofless star trek catan	RowanMMolloy
troyesivan kind lyrical genius	RowanMMolloy
explictroyler target version	RowanMMolloy
progress slow nanowrimo	RowanMMolloy
time buckle write finish book tomorrow nanowrimo	RowanMMolloy
good today nanowrimo	RowanMMolloy
will happen time will nanowrimo	RowanMMolloy
deleted novel undo button time backup nanowrimo	RowanMMolloy
today time double nanowrimo	RowanMMolloy
to today birthday november tomorrow writeoff nanowrimo	RowanMMolloy
feel bad chapters lengths help nanowrimo	RowanMMolloy
nanowordsprints inclusion sunflowers nanowrimo	RowanMMolloy
kimkali nanowordsprints day good luck	RowanMMolloy
word count nanowrimo	RowanMMolloy
troyesivan blueneighbourhood chills	RowanMMolloy
nanowrimo days excited ready nanoprep help	RowanMMolloy
love song plz troye blueneighbourhood	RowanMMolloy
mutantcanuck honestly spectrum involved help people understand disorder weak	RowanMMolloy
helinat nanowrimo struggle waiting update	RowanMMolloy
nanowrimo excited nanowrimo year	RowanMMolloy
nanowrimo deep breath nanoprep	RowanMMolloy
speaking music write best cheesy pop music medieval music setting year nanoprep	RowanMMolloy
brighthappyplnr nanowrimo scrivener nanoprep	RowanMMolloy
bravrayj party butterbeer pen nanoprep	RowanMMolloy
elizabethamber time worry nanoprep	RowanMMolloy
lkajue speaks nanoprep	RowanMMolloy
kaciecruise lose years row going win	RowanMMolloy
plot graphs write november nanoprep nanorebel	RowanMMolloy
year nanowrimo idea	RowanMMolloy
tbt hanging city cool people rs	RowanMMolloy
tbt hair transition	RowanMMolloy
people care open eyes bellletstalk	RowanMMolloy
friend cavalier puppy	RowanMMolloy
christmas gifts dftbarecords whoops	RowanMMolloy
hair benjamin franklin american	RowanMMolloy
katlovinglondon hankgreen johngreen fast	RowanMMolloy
project project currently working sociology partnersformh favourite write	RowanMMolloy
powers child nanowrimo fun	RowanMMolloy
good luck friends working nanowrimo novel nanowrimo	RowanMMolloy
powered writers block computer crashed nanowrimo	RowanMMolloy
charlestrippy nominated peta libby award help win	RowanMMolloy
time days going bit longer tomorrow homestretch	RowanMMolloy
goal hit sprinting time nanowrimo	RowanMMolloy
nanowordsprints nope find space	RowanMMolloy
wrote today tired nanowrimo	RowanMMolloy
kendramase tomorrows halfway day great day catch	RowanMMolloy
reason ready wrap novel uh nanowrimo	RowanMMolloy
guy loves sleep side work	RowanMMolloy
magic couch nerves going explain ugh	RowanMMolloy
nanowordsprints plan nanowrimo	RowanMMolloy
wrote yesterday whoops nanowrimo	RowanMMolloy
huntingdragons frinightwrites ginad cantrelljason asants pencil writes oo	RowanMMolloy
attire cold writer nanowrimo	RowanMMolloy
frinigwhtwrites katebrauning whoo	RowanMMolloy
sigh cyotes tmltalk	RowanMMolloy
sigh pesky errors sad nanowrimo	RowanMMolloy
burst idea story rowan ready hit motivated amwriting nanowrimo	RowanMMolloy
todays nanowrimo playlist tracks libraries lattes nanowrimo	RowanMMolloy
cantrelljason today confident	RowanMMolloy
nanowrimo website update word count	RowanMMolloy
luck teamwork lot paint otto octopus born	RowanMMolloy
kaylabriewilder pushing love idea plan detail detail pants	RowanMMolloy
thesprintshack guys lot nanowrimo	RowanMMolloy
free trial web nanowrimo totally awesome	RowanMMolloy
goal jeffcarter gokingsgo	RowanMMolloy
kurewkreations nanowrimo beautiful	RowanMMolloy
laurenmyrtle fellow hufflepuff appreciate house representation	RowanMMolloy
snazzy case bufferfestival cbc fallforcbc	RowanMMolloy
today crazy fun happy guy day	RowanMMolloy
bettywho glory days obsession	RowanMMolloy
leaf tonight torontomapleleafs tml nhl	RowanMMolloy
starting nanowrimo prep tonight hows prep going	RowanMMolloy
samirossbvb prep people write outlines chapters depends style whynano	RowanMMolloy
novelchronicle coffee blast music enter zone whynano nanorebel	RowanMMolloy
simple beautiful adfree read manifesto	RowanMMolloy
rhettandlink sawyerhartman charlestrippy so ready bufferfestival	RowanMMolloy
bufferfestival charlestrippy going dd	RowanMMolloy
saskiavanell joelksullivan agree best	RowanMMolloy
matthewwatts bufferfestival totally going hope met canadian eh	RowanMMolloy
batman socks nerdfighter dog tags fault stars shirt damn boy alextwestlake	RowanMMolloy
glasses love sweater	RowanMMolloy
nanowordsprints stopping hours good night	RowanMMolloy
frinightwrites going hit tonight goal month writeclub	RowanMMolloy
blasting breathing write campnanowrimo novel focused wethekings	RowanMMolloy
rain shut exam study exams	RowanMMolloy
tfiosfeels laughed cried cheered wished hazel gus infinity nightbeforeourstars faultfanatics	RowanMMolloy
finally settled hockey blackhawks lead	RowanMMolloy
colangelodiana alextwestlake going going awesome	RowanMMolloy
lakings game wilw	RowanMMolloy
nanowordsprints beat night writing campnanowrimo	RowanMMolloy
seraheshoes pollypissypants totally agree	RowanMMolloy
nanowordsprints officially pumped amwriting	RowanMMolloy
galacticrosebud best spent	RowanMMolloy
laptop hand warmers form toast lucky hat ready work	RowanMMolloy
quick editing ready stupid book mackavaldez amwriting campnanowrimo	RowanMMolloy
nanowordsprints nancykelley livanto coffee	RowanMMolloy
running final omgrobots packing north bay	RowanMMolloy
really vocal assignment exist	RowanMMolloy
join in hours good luck writeclub	RowanMMolloy
frinightwrites book details needed ironed	RowanMMolloy
guess late night snapback selfies thing	RowanMMolloy
day frcgtrw frc going strong omgrobots	RowanMMolloy
youknowyourecanadianwhen you lost roll rim ain	RowanMMolloy
writing zombies watching movies going dinner good start week	RowanMMolloy
sportswithjohn bronco player green dave	RowanMMolloy
game tlwkin days	RowanMMolloy
wowustolemyurl app sounds cool	RowanMMolloy
team won bellletstalk donate money mentalhealth today wonderful day	RowanMMolloy
bellletstalk mentalhealth suicide	RowanMMolloy
instagram send help	RowanMMolloy
nativecry redtigermark sending it starts rightbyyou	RowanMMolloy
nlibrisveritas basically yearold fangirl asked wanted	RowanMMolloy
wilw beautiful mentalhealth speech	RowanMMolloy
recommend working english projects school library funny sit fireplace meh	RowanMMolloy
nanowrimo memorize englishclass	RowanMMolloy
nanowordsprints wordsleft nanowrimo	RowanMMolloy
helped month guys absolutely amazing korbust	RowanMMolloy
kendramase discovered twitter month yougo kday	RowanMMolloy
ericnentrup forcing sleep hour nanowrimo	RowanMMolloy
grammarm nanowordsprints best youwin	RowanMMolloy
whoo nanowrimo ktogo	RowanMMolloy
sick day tomorrow feel bleh years missing nanowrimo	RowanMMolloy
writer writing book month friends going you time	RowanMMolloy
kind writing amwriting btsov nanowrimo	RowanMMolloy
title bytheswordofvane btsov	RowanMMolloy
yazzijade sprint cleaning	RowanMMolloy
frinightwrites late tea called kick writers block face good nanowrimo	RowanMMolloy
frinightwrites minutes late left writeclub	RowanMMolloy
writing frinightwrites tonight writeclub allin	RowanMMolloy
decided tonight write bit tomorrow morning class nanowrimo goals	RowanMMolloy
god days nano bufferfestival better moving nanowrimo writinglikecrazy	RowanMMolloy
crazy thought tomorrow sitting tiff watching youtubers lovecoreyvidal corradocoia will amazing bufferfest	RowanMMolloy
voted epic rap battles history win artist year youtube music awards ytma	RowanMMolloy
nanowordsprints nanowrimo year onfire amwriting	RowanMMolloy
nanowordsprints character told food eat close	RowanMMolloy
nanowordsprints word count day finished lunch break supportive french teacher nanowrimo goalmade	RowanMMolloy
corradocoia purchased tickets online confirmation email	RowanMMolloy
bufferfestival yay buying tickets tomorrow excited bufferfestival	RowanMMolloy
heyimissie alextwestlake preach	RowanMMolloy
rush song stuck head wakemeup wakemeupwhenwehaveanewrushsong	RowanMMolloy
coffeecoffeecoffeecoffee ohgod tsbnickyear	RowanMMolloy
late night writing tsbnick working finishingachapter aspeckofdust	RowanMMolloy
alextwestlake pokes tsbnick feel clogging newsfeed i ashamed	RowanMMolloy
hallway interesting morning tsbnick tsbnickyear	RowanMMolloy
hey tsbnick birthdayyyyyyyyy	RowanMMolloy
watching tsbnick fangirl hilarious tsbnickyear	RowanMMolloy
sitting library tsbnick kingoknex chodingyeonie tsbnickyear	RowanMMolloy
corradocoia pretty favourite photograph	RowanMMolloy
feels odd write ish today needtowrite noinspiration	RowanMMolloy
short chapter things moving detailed writerproblems	RowanMMolloy
days campnano workinghard nanowrimo writing	RowanMMolloy
reallyloving karenkavett videos amazing	RowanMMolloy
writing going nope bluejaysgame canadaday procrastinating	RowanMMolloy
watching television watch lot doctor sherlock big bang theory	RowanMMolloy
hankgreen happy birthday facebook fans	RowanMMolloy
nanowrimo hot coffee ready idea will fun	RowanMMolloy
corradocoia drawing fridge wondering exists house	RowanMMolloy
harken best thing writing harken	RowanMMolloy
nanowordsprints fantastic totally hours bring	RowanMMolloy
corradocoia chance signing shirt tomorrow chance will buy coffee tommorrow	RowanMMolloy
bought vest dress shirt coffee corradocoia	RowanMMolloy
shoutouts tyleroakley live	RowanMMolloy
hey realjohngreen nerdfighter hit fans	RowanMMolloy
samanthafall corrado hat waiting week	RowanMMolloy
wheezywaiter bently cavalier	RowanMMolloy
join tomorrow celebrate named canadas best diversity employers gtas top employers	RyersonU
celebrate ontario biologyday	RyersonU
ryersons top speaker watch students test oratory skills tonight	RyersonU
good morning ryerson open house visitors today ryerson	RyersonU
sosieductive letting check ryersonfixit hopefully laptop	RyersonU
visit ryerson open house springbreak friday	RyersonU
ryersonrams chances cisbball national championships sportsnet	RyersonU
join ryersonfcad special screening friendinabox closet monster thursday	RyersonU
slice piday rain moved inside pod rest assured	RyersonU
ryersonrams womens basketball final follow gold werrams	RyersonU
ryerson phd student working ryersoncue address range anxiety electric vehicles ontario	RyersonU
visit ryerson march break will happen	RyersonU
rslc main lobby tomorrow dye cut hair help raise money children living lifethreatening medical conditions	RyersonU
celebrate wisryerson ryerson boneleslies initiative iwd	RyersonU
congratulations dr juanita westmoreland traor award professor jennifer clarke	RyersonU
monday lunch easy	RyersonU
ryersons murtaza haider comments state torontos transportation system globeandmail	RyersonU
tweet photo robot ryersonfrc visit ruengineering booth chance win oua basketball playoff tickets mattamyac	RyersonU
interim president mohamed lachemi announces raised special help scotiabank sarabjit marwah rslc	RyersonU
anyssaclose reaching whyryerson will help questions	RyersonU
forward welcoming spectators special guests today host ryersonfrc event canfirst rufeas ryersonsci	RyersonU
board senate elections vote online feb mar pm	RyersonU
taki open today	RyersonU
xsalameh closures inform moment monitoring closely updates will posted	RyersonU
kerriandreas rest assured changes uncross fingers hard write exam	RyersonU
dd monitoring weather closely will update pm	RyersonU
monitoring weather conditions closely check day weather schedule updates	RyersonU
larscroft university open classes running scheduled monitor weather provide updates today	RyersonU
tiffnet ryerson panel arts culture toronto march	RyersonU
excited cities migration conference read qa audsinger advance conference	RyersonU
love campus share photo ryersonalumni chance turn card	RyersonU
tiffnet ryerson arts culture panel march learn	RyersonU
photographers grab pic ryersonu snow chance featured ryersonalumni holiday card	RyersonU
ryerson mind action speaker series tuesday charlesfalzon moderating discussion	RyersonU
upadhyayparam fall love	RyersonU
fizzachaudhry stay tuned updates	RyersonU
excited special year anniversary rslcyr	RyersonU
ryersondmz kathleenwynne announces investment partnering ibmcanada oceinnovation	RyersonU
gowrysiva hope better stay tuned accounts updates weather tomorrow	RyersonU
ujalagosai cheers view rslcyr	RyersonU
grad students rsvp expert panel career pathways graduate success feb gradtalks lecture	RyersonU
week big year anniversary rslc share favourite memories week rslcyr	RyersonU
latest trsmryersonu study investigates spending habits frugal	RyersonU
grad students rsvp expert panel career pathways graduate success feb gradtalks lecture	RyersonU
happy partnering stmikeshospital	RyersonU
free legal advice clinic hosted ryerson law centre thursday trsmryersonu register	RyersonU
discussing personal narratives oliviachow jack layton leadership school	RyersonU
january announced social enterprise demonstration fund young entrepreneurs	RyersonU
mohamed lachemi premier kathleenwynne ontario trade mission india	RyersonU
wayne embry shared inspires mkt students people work succeed trsmryersonu	RyersonU
ryersonrams basketball teams wrap season saturday time nbaallstar protectthemac time	RyersonU
nights special presentation mac ryerson theatre school students mark singelis ryan sheppard	RyersonU
today pm usetherightwords canadian media reporting sexual violence ryersonjourn	RyersonU
passionate fashion learn changschool summer fashion intensive certificate enrollment open	RyersonU
late learn ryersons budget development academic year town hall today pm	RyersonU
ryersonrams basketball incoming weekend	RyersonU
tomorrow pod ryersonsecurity cpo talk responsible drinking check rustudentlife video	RyersonU
rslc bttoronto jennvalentyne late	RyersonU
don number ryersonrams wluathletics night protectthemac werrams	RyersonU
insightful dmzsession ryersondmz learn sharing economy week	RyersonU
allan slaight radio institute opens rtaryerson alancross will broadcaster residence	RyersonU
exercise curiosity learn favourite collaborative space architecture designlines	RyersonU
attn students summer coming join summer work experience career fair today prepped	RyersonU
thursday tech writer fmanjoo talks ryerson cool ready	RyersonU
ryerson faculty members interview topics edaw onpse	RyersonU
students faculty staff invited celebrate equity diversity inclusion feb alan shepard edi awards	RyersonU
learn pros cons journalism experts debate neutrality journalism ryersonrjrc feb	RyersonU
ryerson faculty members interview topics edaw onpse	RyersonU
aahildayani contact info	RyersonU
lifechanging experience meets longterm success ryerson learn	RyersonU
interested ryerson governance attend session board senate elections feb noon jor	RyersonU
jlabove find cake	RyersonU
top ranked mens basketball team canada ryersonmbb werrams ryerson	RyersonU
time journalists abandon ideal neutrality visit ryersonrjrc february find	RyersonU
dates board senate electionsfeb call nominationsfeb pmsharp close nominations	RyersonU
filmmaker marketing executive barry avrich appointed distinguished visiting professor ryersonfcad	RyersonU
check zerotostartup providing youth ages experience technology entrepreneurship	RyersonU
hat cattle mens hockey team brock annual country night mac jan pm werrams	RyersonU
attn students kick semester free hot lunch rlsc tomorrow noon pm	RyersonU
active eat better involved great activities mac jan	RyersonU
join huge game mac ryerson rams womens hockey team takes rival york lions fri january free onecard	RyersonU
jan public realm open house share ryerson campus priorities	RyersonU
check lithoform ryersondas student submission years winter stations competition	RyersonU
attn students kick start years resolutions visit mattamyac jan help inspiration	RyersonU
build community develop professionally foster leadership women planning forum jan	RyersonU
attention graduate students registration three minute thesis competition open oneslide minutes	RyersonU
ryerson today will return inbox fresh design january	RyersonU
things visit ricgallerys exhibitions work contemporary female artists opening jan	RyersonU
holiday message ryerson interim president mohamed lachemi	RyersonU
applied transfer credits review your transfer credit report ramss ryerson	RyersonU
jan public realm open house share ryerson campus priorities	RyersonU
ryersonexams announcement students will admitted pm leave exam hour	RyersonU
opinion matters public realm jan open house hear share ideas ryerson evolving campus	RyersonU
rufacultyofarts program pairs ryerson students students released prison break stereotypes	RyersonU
rufacultyofarts morton beiser leading pilot project help syrianrefugees posttraumatic stress disorder	RyersonU
joins today noon discussion indigenous consent canadian mining	RyersonU
true will cookies hot chocolate dec jor lobby hear santa will visit dec	RyersonU
free legal advice law centre miller thomson campus today pm preregistration required	RyersonU
free legal advice law centre miller thomson campus dec pm preregistration required	RyersonU
checked brand refresh brand story story impact	RyersonU
join ryscidean learn basic coding hour handson tutorial dec	RyersonU
exams full undergraduate list ryersonexams	RyersonU
kirstendavey contact info	RyersonU
burning midnight oil late night studying ryersonexams	RyersonU
congratulations ryerson student annugaidhu placing ivhq volunteer year awards	RyersonU
ryersonexams kick week today tips tricks time	RyersonU
candlesticks nice givingtuesday create opportunity ryersonu students gift change lives	RyersonU
givingtuesday celebrates collective power generosity help strongerru	RyersonU
ryequity discussing governance risk management distinguished visiting prof alok mukherjee ryersonedi	RyersonU
dogs puppies video therapy dogs visit ryerson rutherapydogs	RyersonU
support assistance writing exams ryersonsls help ryersonexams	RyersonU
join panel violence women identify preventative solutions campus dec pm	RyersonU
trsmryersonu airports europe latin america mobilefriendly techsavvy passengers	RyersonU
join dec committee panel gun control ryersondec endvaw ryersonedi	RyersonU
ryerson host speaker panel gun violence women nov pm ryequity	RyersonU
startup media coverage ryersondmz panel journalism pr pros dec dmzsession	RyersonU
term impending exams stressing ryerson moves offering yoga meditation classes nov	RyersonU
highlights struggles faced canadians battling diabetes food insecurity foodinsecurity diabetes	RyersonU
renowned choreographer james kudelka joins ryersonfcad rtsryerson kudelka meets ryerson dances	RyersonU
zenken vicecanada heart downtown toronto	RyersonU
join rufeas opening newly renovated wind tunnel today pm	RyersonU
construction daphne cockwell health sciences complex shortly parking lot church dundas closed	RyersonU
november trans day remembrance tonight hosting panel discussion join	RyersonU
ryerson graduate maayanziv creates app leading welcoming accessible accessnowapp	RyersonU
applied transfer credit required submit course outlines visit ryerson	RyersonU
join untangling aftermath arab uprisings western policy responses nov pm	RyersonU
feeling ruff paws therapy dogs today kerr hall west lower gym	RyersonU
idea business tech social venture discuss big idea coffee mentors enactus	RyersonU
todays gift brookfield institute cockwell family ryerson	RyersonU
ryerson global innovation challenge applications open nov create viable business ideas	RyersonU
prof cheri bradish car makers spend sponsoring sports	RyersonU
chillin gould nov pm support united ruunited	RyersonU
celebrate official opening ryersons newly renovated subsonic wind tunnel nov	RyersonU
prof cheri bradish car makers spend sponsoring sports	RyersonU
student affairs neighbour project connects students residence community organizations	RyersonU
ryerson host toronto charity homeless connect mattamyac sunday	RyersonU
tsnbobmckenzie talks fond memories covering ryersonrams	RyersonU
deantrsm talks globeandmail ryersonmbas ranking theeconomist ryerson	RyersonU
ryerson community invited pay tribute canadas fallen nov	RyersonU
applied transfer credit required submit course outlines visit ryerson	RyersonU
happy wednesday ramily call toronto	RyersonU
prof frank russo brain body reacts music yahoohealth ryerson	RyersonU
intrepid ryerson partner experiential learning trip cuba travelweekgroup	RyersonU
rams basketball teams opener varsityblues students faculty staff attend free onecard	RyersonU
ryersoncue torontohydro collaborate battery storage project campus ryerson	RyersonU
grab tickets rtsryerson sixplay series suburban motel filthy rich	RyersonU
tickets ryerson theatre schools sixplay series suburban motel filthy rich	RyersonU
ryersonjourn alum cbchereandnow producer ingwongward shares great career advice	RyersonU
reminder participants nov apply attend years tedxryersonu conference	RyersonU
rtaryerson professor hossein rahnama appointed visiting scholar medialab	RyersonU
difference consider donating ryersons united campaign ruunited	RyersonU
math researcher pawel pralat models experiments provide insights social network structures evolve	RyersonU
mohamed lachemi appointed interim ryerson president	RyersonU
grad students enter grad word second video contests win prizes totaling ryerson	RyersonU
ryersonjourn alum cbchereandnow producer ingwongward shares great career advice	RyersonU
explore public cultural performance ryersonfcads performigrations exhibit friday	RyersonU
meet goal help support community donation united ruunited	RyersonU
ryersons emergency awareness preparedness response procedures visit	RyersonU
happy wednesday launched united campaign donate help thousands people ruunited	RyersonU
ryerson students timberfever	RyersonU
rsvp oct info session ryersons master social work program	RyersonU
check zone learning darth vader challenge tomorrow pm launchzoneru floor slc	RyersonU
celebrate the growing season ryeshomegrown oct rueats snacks prizes	RyersonU
congrats prof marsha barber ryersonjourn prof awardwinning poet attend book launch oct	RyersonU
attend oct learn advances tech ryerson researchers students great discount	RyersonU
goenggirl tomorrow ryerson engineering hosts handson fun engineering program girls gr	RyersonU
explore public cultural performance ryersonfcads performigrations exhibit oct	RyersonU
big congrats graduates convocating today roadfromryerson	RyersonU
ryerson students building greenhouse naujaat grow cheaper food ctvnews	RyersonU
love hockey dennis miles changschool copublished photography book games gardens acc toronto	RyersonU
blue sky gold leaves ryerson rucampus	RyersonU
learn ryerson students building greenhouse naujaat grow cheaper food ctvnews	RyersonU
goodbye shy ryersonpsych prof martin antony people develop shyness ryerson	RyersonU
smlabtos polidashboard reveals people federal election cdnpoli elxn	RyersonU
female entrepreneurs hope spark wave womenled ventures ryersondmz ryerson financialpost	RyersonU
ryersons womens hockey opener tomorrow cheer werrams	RyersonU
thinking grad school rsvp tomorrows yeates school graduate studies open house ryerson	RyersonU
ryerson students launchzoneru slc floor demo yahoos yahoolivetext pm	RyersonU
ryerson student invited demo yahoos yahoolivetext app tomorrow pm launchzoneru rslc	RyersonU
join tomorrow pm gould victoria united campaign launch ruunited	RyersonU
immune unethical business practices prof chris macdonald explains cbprofit ethics	RyersonU
october cyber security awareness month check series events ryerson hosting	RyersonU
great opportunity rustudentlife care	RyersonU
attend trsmryersonu exchange program info session happening tomorrow trs pm	RyersonU
ryersonmba ranked best mba programs canada trsmryersonu cdnbiz	RyersonU
looked dapper ryersonalumni scarves	RyersonU
broadband key infrastructure st century piece prof catmiddleton usconversation	RyersonU
thinking grad school rsvp oct yeates school graduate studies open house ryerson	RyersonU
human rights services committed creating community dignity members upheld ryersonedi	RyersonU
grab free toque gould street party card ruaw	RyersonU
weday toronto ryerson supporter sponsor	RyersonU
years days support trimentoring program birthday small donation tmpturns	RyersonU
vote favourite timberfever structure poll closes pm ryerson	RyersonU
order textbooks online tomorrow chance win rucampusstore ryerson	RyersonU
ram ram celebrate gould street party oct ryerson ramily ruaw	RyersonU
ryersons trimentoring program turns year help raise days tmpturns	RyersonU
good morning ryerson catch rslc saturdays globeandmail good credit novosedlik	RyersonU
future rams coming ouf don valley parkway will closed weekend plan ahead	RyersonU
catch timberfever weekend ryersondas mosesstructures host design construction competition	RyersonU
great energy ouf teams ready questions visit ryersonouf booth	RyersonU
icymi ryersondmz innobham team initiative supporting global entrepreneurship	RyersonU
join soup substance blacklivesmatter equity social justice policing sept pod	RyersonU
ryerson offers free financial literacy course students sign rudebtfree	RyersonU
check farmers market today gould st pm grab lunch fresh produce golocal rueats	RyersonU
blogto names ryerson alum andrew cividinos sleeping giant best movies tiff	RyersonU
catch timberfever weekend ryersondas mosesstructures host design construction competition	RyersonU
architectural science welcomes awardwinning architect nasrine seraji thurs ryerson	RyersonU
check free community skate mattamy athletic centre tomorrow pm	RyersonU
changschool dean marieatryerson talks canadianliving going school adult ryerson	RyersonU
attend disability media digital stories artist activist elizachandler sept event free	RyersonU
ryersondmz innobham team initiative supporting global entrepreneurship	RyersonU
dayfat dave metrolinx charge app direct questions	RyersonU
going tiff record number films ryerson alumni year festival	RyersonU
tiff ryerson grads action	RyersonU
ryersonfcads mobile learning project aims create mobilefriendly environment	RyersonU
executive chef joshnamaharaj talks cbcnews avoiding freshman ryerson	RyersonU
roderickbconte rurecreation share ryersonfixit fixitryersonca	RyersonU
volunteer opportunity help ryerson aircanadacentre weday oct	RyersonU
ryerson filmmakers debut sleeping giant tomorrow tiff ryersonfcad	RyersonU
ahnansii ryerson security investigating matter info contact security securityryersonca	RyersonU
gpd offensive signs condoned ryersonu ryerson group report ryersonfixit	RyersonU
beesince ryerson security investigating matter info contact security securityryersonca	RyersonU
terrylknox ryerson security investigating matter info contact security securityryersonca	RyersonU
offensive signs condoned ryersonu ryerson group report location ryersonfixit	RyersonU
rusulalrubail working remove offensive signs oncampus report location ryersonfixit	RyersonU
questions follow ruservicehub answers enrollment class schedules ryerson	RyersonU
monday ramily stay positive work hard happen	RyersonU
hope enjoying concert ryerson rsuwow	RyersonU
dmep congratulations mindandaction social media contest winner email ryersoncgcegmailcom details	RyersonU
rsvp today gradcafe gradspace open house grad students meet deans light lunch	RyersonU
libbyital hear contact ryesu concert follow rustudentlife info student life	RyersonU
join welcoming deborah newman appointed distinguished visiting scholar ryerson	RyersonU
special heads gould st will closed fri pm ryesus final week concert share updates tomorrow ryerson	RyersonU
excited tiff check record number films ryerson alumni set screen festival	RyersonU
blairscorgie rysurp blair	RyersonU
wonderful initiative rustudentlife inspired talented student photographers snapping ryerson instagram	RyersonU
to school changschool dean marieatryerson overcome excuses canadianliving	RyersonU
ready team skills test enter timberfever design challenge ryersondas mosesstructures	RyersonU
teams will compete st mosesstructures timberfever designbuild challenge sign sept ryersondas	RyersonU
happy wednesday ryerson gould st farmers market pm quad noon pm picnic	RyersonU
students visit mind action booth gould st enter win rucampusstore mindandaction	RyersonU
rslc style visiting flarefashion	RyersonU
happy long weekend reminder ryerson closed monday labour day tues sept	RyersonU
attending todays poetry slam location changed lib ryerson	RyersonU
great event ryersoniss celebrating ryersons cultural diversity campus	RyersonU
happy snickers enjoying paws oweek rutherapydogs ryerson roadtoryerson	RyersonU
stay hydrated ramily	RyersonU
friendly heads parking lot churchdundas will limited spots sept development	RyersonU
ready party year gould street party coming ryerson oct	RyersonU
icymi yesterday watch bttoronto broadcast live campus roadtoryerson	RyersonU
ryerson canadian universities seda accreditation utdp program	RyersonU
join accessryerson learn best barrierfree routes travel campus ryersonedi roadtoryerson	RyersonU
fun fact roadtoryerson trending topic yesterday great orientation week class	RyersonU
men skirts drbenbarry fall fashions blurred gender lines flarefashion ryerson fashion	RyersonU
future sports happening dmz entrepreneurship	RyersonU
students corner gould victoria live bttoronto monday participants will prizes giveaways	RyersonU
ryerson offers free financial literacy course students sign rudebtfree	RyersonU
alumni weekend oct help spread word social media ambassador ruaw	RyersonU
apply letter permission plan courses college university ryerson	RyersonU
exhibit paul cocker gallery showcases toronto city hall competition ryersondas	RyersonU
bof ranks ryersons school fashion top fashion school canada pse	RyersonU
president sheldon levy talks ryersons campus transformation thetorontosun	RyersonU
fun fact mount vesuvius erupted onthisday year ad burying roman city pompeii	RyersonU
learn summer prep courses students ryerson	RyersonU
lib jor slc pod rac power pm tonight will closed community ryerson	RyersonU
fortyork time tablet experience developed ryerson researchers spacechannel	RyersonU
arc eng building will power tonight pm will closed community ryerson	RyersonU
heart toronto teen attending ryerson launchzoneru basecamp builds heart alert device ailing mother	RyersonU
paperless office digital dream trsmryersonu prof joanne mcneish talks ctvtoronto	RyersonU
reminder trsm eph buildings power pm will closed community ryerson	RyersonU
bust myths ontsciencectr enjoy ryerson friends family day aug enjoy giveaways special discount	RyersonU
prof lloydalter competencybased education big thing ryerson mothernaturenet	RyersonU
prof cheri bradish andrew wiggins kyle lowrys endorsement deals bmo torontostar ryerson sports marketing	RyersonU
friendly reminder ryerson will conducting fall fire drills starting sept btw pm visit details	RyersonU
student access priority servicehub opening aug hub dining area ruservicehub ryerson	RyersonU
icymi ibm opens bluemix garage dmz ryersondmz informationweek toronto entrepreneurship	RyersonU
school changschool dean marieatryerson explains ryerson education	RyersonU
review list upcoming power disruptions closures ryerson campus ensure	RyersonU
sin number start working	SallySan_x
grandad apple mac ipad iphone toshiba laptop falling apart cracked iphone	SallySan_x
regret avocados packed bags left boyproblems	SallySan_x
learn leaving revision till minute bad grades	SallySan_x
asklloydsbank transfer hav call authentication changed number canadian number	SallySan_x
gotta wait hours hitting gym shopping time	SallySan_x
drunk bae rolled drunk impressed	SallySan_x
guys gaming seriously	SallySan_x
chatime bakecode opening shophillcrest dec join dec grand opening specials	SallySan_x
everytime phone battery percentage hell	SallySan_x
start eating healthy	SallySan_x
leaving tomorrow fuck life	SallySan_x
lm omg real mum coming	SallySan_x
start applying jobs	SallySan_x
proof read send email mistake making mistakes acceptable lol	SallySan_x
help win awesome giveaway dave lackie	SallySan_x
royalmail hope return package asos refund lost post	SallySan_x
strawberry banana smoothie lunch tomorrow healthy diet beachbody holiday	SallySan_x
jealous canadians going digital dreams weekend	SallySan_x
specsavers bloody expensive lenses	SallySan_x
femail mailonline wow amazing	SallySan_x
newlookfashion hey find top website	SallySan_x
purchased maccosmetics lipstick heroine purplelipstick	SallySan_x
debenhamsbeauty voted faced chocolate bar palette	SallySan_x
starting job monday nervous newstart	SallySan_x
lot ratchet chicks wirral	SallySan_x
free lunch work	SallySan_x
work training sunday	SallySan_x
buy one half price hollandbarrett booteafitness booteauk healthandfitness detox	SallySan_x
hands calvin harris leaked photos	SallySan_x
days left till work	SallySan_x
employment offer letter post morning excited newjob newstart	SallySan_x
toothache worst pain	SallySan_x
icelandfoods fell love iceland pizzas years ago definitely best frozen pizzas	SallySan_x
happy things starting newjob newexperience	SallySan_x
hongbinss yeah course	SallySan_x
quizclothing minus kim kanye	SallySan_x
valentines day week spending night bed foreverlonely single gettingold stillsingle	SallySan_x
missing canadian family	SallySan_x
echoarena liverpoolone topgearlive love	SallySan_x
narsissist sephora will palette uk	SallySan_x
dominosuk hunger dip domimovies	SallySan_x
tuna sweet corn sandwich full stomach bed	SallySan_x
running win feel unique voucher staceysmum win bbloggers beauty loulvsfeelunique	SallySan_x
jeremitsme jessicas food cheese butter	SallySan_x
win bose soundlink bluetooth speaker worth sprinkleprizes sprinklecom	SallySan_x
email won real technique brushes super excited makeup	SallySan_x
sleeping full stomach torture body	SallySan_x
dailymail mailonline greedy women	SallySan_x
nb happened jeremy sweet sour porn sweet sour pork	SallySan_x
nb working mums friend gonna wait till christmas hows job hope better	SallySan_x
sister work morning nap will lose pounds napping	SallySan_x
davelackie happy lancome grandiose mascara list definitely favourite mascara	SallySan_x
win bottle prada candy florale	SallySan_x
cold today wanna stay bed	SallySan_x
happy birthday nb	SallySan_x
debenhamsbeauty hoola bronzer contouring face abenefitxmas	SallySan_x
nb job interviewed trick haha	SallySan_x
nb lot examples scared will throw deep lol	SallySan_x
sister costco lazy drag ass bed	SallySan_x
nb dinner lol oops	SallySan_x
batistehair missguided wear comfortable clothing shoes	SallySan_x
nb application denied job applied meet criteria	SallySan_x
nb toronto lol	SallySan_x
sweating online assessment job application	SallySan_x
time ombre recoloured brassy blonde hairstyle	SallySan_x
nb solid questions struggling	SallySan_x
waking dead time	SallySan_x
nb yeah feel	SallySan_x
debenhamsbeauty unpack luggage spent years canada happy	SallySan_x
hongbinss talk talk virgin	SallySan_x
hongbinss allow check save money	SallySan_x
hongbinss knew grow bet feel guilty spending kpop lol	SallySan_x
love testing products boots free beauty products	SallySan_x
bourjoisuk received prize wait nail polishes lipstick happy halloween	SallySan_x
listen tiesto hardwell twoloud remix free download hardwell np soundcloud	SallySan_x
nb great honest fan sweet stuff	SallySan_x
nb hahahah serious	SallySan_x
jadeelliott cleanse toner moisturizer bed	SallySan_x
hongbinss yes excited cheap food	SallySan_x
friends uk hurry august	SallySan_x
going england toronto	SallySan_x
nb booked ticket september ball eyes	SallySan_x
losing weight easy nomotivation fatlife fitness health	SallySan_x
hongbinss will friends will boat worry	SallySan_x
love view niagarafalls canada stunning	SallySan_x
hate you remember hours	SallySan_x
heat killing hot torontoproblems	SallySan_x
outfit sorted festival	SallySan_x
craving chatime recommend chatimeuk milk tea green tea passionfruit taro	SallySan_x
nb hahhahaha hidden time stamp sneaky	SallySan_x
nb xxxx nice day xx	SallySan_x
nb wanna skype	SallySan_x
chatimeuk super size pearl milk tea chatime toronto people finish	SallySan_x
nb hahhahahaahahahah eating good food	SallySan_x
digidreamsfest giveaway missed	SallySan_x
nb closet slut	SallySan_x
nb add app	SallySan_x
nb hahhahahaahahahah bitch	SallySan_x
weeks tan lose pounds digitaldreams rave edm	SallySan_x
nb holy shit	SallySan_x
love urbandecay naked palettes	SallySan_x
nb learn best	SallySan_x
nb talk hand	SallySan_x
nb heard yasmina messaged april rely replied	SallySan_x
nb yeah definitely cake face phone screen crack	SallySan_x
nb ditched uthats pretty messed making wait hour	SallySan_x
nb violent thug word	SallySan_x
nb omg moaning lethal pinchesslaps lol	SallySan_x
going surrounded kids veld	SallySan_x
postoffice letter malta directly address toronto	SallySan_x
nb work today bored lol	SallySan_x
things happen reason	SallySan_x
nb cute good ready wrk bday good	SallySan_x
nb gonna expensive process decision	SallySan_x
citimmcanada students graduate years diploma college eligible apply post graduation work permit	SallySan_x
nb hahahahaha yeah long	SallySan_x
nb painkillers good coughing better hows	SallySan_x
nb job sticking current job months left	SallySan_x
nb thinkin talk twitter posting	SallySan_x
nb free skype virus going	SallySan_x
vad haha deserves title	SallySan_x
laidback luke march	SallySan_x
knifepartyinc rumors guys will coming toronto digital dreams hope true	SallySan_x
nb omg nasima fine will buy hav milky bar hav malteasers taste	SallySan_x
sushi brunch nice start day	SallySan_x
nb yay interviews	SallySan_x
tempted naked basic eyeshadow palette question	SallySan_x
nb find read hows job hunting	SallySan_x
nb feel disgusting lol	SallySan_x
delicious chicken curry feelingproud	SallySan_x
love super bowl advert bestbuds	SallySan_x
going long busy day work	SallySan_x
nb going good november will start planning itinerary summer	SallySan_x
nb ohhhh noooooo	SallySan_x
nb inspired human centipede sister messaged whatsapp watching second	SallySan_x
thought snow wrong toronto winter	SallySan_x
netflixca walking dead season	SallySan_x
nb skype tomorrow friday	SallySan_x
thinking sister happy yeahits pretty strange	SallySan_x
veldfest veld tickets	SallySan_x
nb fine offering will check mac bit cheaper high cosmetics	SallySan_x
nb pay monthly netflix help lol	SallySan_x
nb reply kik	SallySan_x
nb jeremys going house party	SallySan_x
going guelph today spend weekend family excited cousins	SallySan_x
love urbandecay palette christmaspresent	SallySan_x
missed second batch visas chance january	SallySan_x
nb will decide	SallySan_x
hate canadian winter cold brit handle toronto	SallySan_x
ttchelps spadina time experienced unreliable service bf ended walking frm spadinadundas bathurst	SallySan_x
keinohrtini laurenbeautyy asos free international delivery	SallySan_x
hongbinss laziness future lisa deciding	SallySan_x
virginmobilecan network friend text call phone network	SallySan_x
urbandecay ud coming toronto	SallySan_x
blawrie defiantly best thing sleep golf watching sunset rise	SallySan_x
nb omg years ago cute expensive	SallySan_x
nb crazy brought jenny girl dirty	SallySan_x
nb chinglish speaks cantonese call chinese people speak bent cantonese lol	SallySan_x
nb kids cantonese better hold conversation	SallySan_x
nb anne speaks shit cantonese understand	SallySan_x
nb hate job months growing	SallySan_x
digital dreams festival hmmm decisions decisions	SallySan_x
yyifans ipad ipad	SallySan_x
yyifans long wedding	SallySan_x
nasima big pay cheque time working full time hours week good hows work	SallySan_x
cook people disaster	SallySan_x
yyifans sony netbook died hard drive screen	SallySan_x
love pizza pizza best pizza place toronto	SallySan_x
nasima making notes hours payment	SallySan_x
netflixca interested signing walking dead season watch online	SallySan_x
mailonline unhygienic leave desk cutlery	SallySan_x
natashaanthea telling friend today awesome met canada	SallySan_x
nasima desperate money pay job weeks paid	SallySan_x
nasima wednesday scheduled work day switched shifts coworker	SallySan_x
abigaylelarson live trump elected	shawnaoh_
keanadimartino lawson dead	shawnaoh_
michellamaggio femaletexts ahh bio reading longest time lmao	shawnaoh_
bruiseaurora nikkilipstick taylorgates	shawnaoh_
happy happy happy	shawnaoh_
fun annoying conflicted kinda	shawnaoh_
life big sigh	shawnaoh_
keanadimartino talking atm hickey neck explains lot	shawnaoh_
wonder minions tomorrow	shawnaoh_
winter ball better senior sail tbh	shawnaoh_
going vance joy	shawnaoh_
bchydro power hours fucking	shawnaoh_
halsey bff diysignblog	shawnaoh_
st day summer school wait	shawnaoh_
twerkling pizzahut wheezed dkkdkapd	shawnaoh_
horoscope told hopefully works favour	shawnaoh_
wait move vancouver	shawnaoh_
gurshdeogan happy birthday gursh	shawnaoh_
happy bday fav person tammylu hope bestest bday	shawnaoh_
shiza shaves pubes toilet	shawnaoh_
finish full season friends day haha hate	shawnaoh_
love locket bath bomb	shawnaoh_
sarajangster twerkling mad fuck	shawnaoh_
bathing solution worlds problems	shawnaoh_
jamalabc family sized tub cheese balls christmas god bless	shawnaoh_
oliviashannnon gwgsyahs dodos ehy olive	shawnaoh_
christmas music radio	shawnaoh_
holy fuck love script	shawnaoh_
weathers supposed decent matters	shawnaoh_
resumes hard write good	shawnaoh_
man going die	shawnaoh_
jennaforster ya joanne tf	shawnaoh_
rileyperri super dope	shawnaoh_
conjuring hour movie telling white people stupid	shawnaoh_
indecisive piece shit	shawnaoh_
post concert depression hitting hard rn	shawnaoh_
skarlethp happy birthday lovey love hope day amazing	shawnaoh_
time joanne fucking sleeping	shawnaoh_
annaastren happy birthday vienna hope bday swag pls change rock	shawnaoh_
sleep listen overwhelming amount sad songs	shawnaoh_
gurshdeogan positive lol love math	shawnaoh_
today father learned open tab internet explorer	shawnaoh_
math midterms going overdose advil	shawnaoh_
wanna laptop fixed play sims	shawnaoh_
mod sun love dayswithdiane	shawnaoh_
lol everyones annoying	shawnaoh_
exactly year ago today	shawnaoh_
ohmyhood happy birthday lovey	shawnaoh_
jaeinjeong funny math	shawnaoh_
episodes breaking bad	shawnaoh_
fattyofcakes changing tomorrow friday	shawnaoh_
sum help sleep	shawnaoh_
episodes breaking bad netflix	shawnaoh_
veronicadessa happy birthday	shawnaoh_
girl care bought today goddamn snapchat stories	shawnaoh_
lol tests classes tmr	shawnaoh_
people supposed to	shawnaoh_
replying textssnapchats dropped phone floor lazy pick suffer	shawnaoh_
people survive wifi	shawnaoh_
hombosexuals fucking caused actual pain hate	shawnaoh_
sarajangster pho bb	shawnaoh_
amount cat pictures mccargar facebook overwhelms	shawnaoh_
jaeinjeong feel sick drinking so good	shawnaoh_
joanneoh bc class	shawnaoh_
jamalabc joanneoh god	shawnaoh_
nightowl alive understand	shawnaoh_
kaileyhbu kaileys attempt clever pt	shawnaoh_
kaileyhbu clears throat died bc hated	shawnaoh_
nightowl positive thing living vancouver	shawnaoh_
call mature unfriending facebook argument hell prove	shawnaoh_
realized love bueno bars	shawnaoh_
happy halloween cheryl mccargar	shawnaoh_
hombosexuals result sneezing tbh	shawnaoh_
hombosexuals sushi sushi metro babe	shawnaoh_
holy shit terrified	shawnaoh_
will die midol advil	shawnaoh_
loved whyd leave	shawnaoh_
guy front bus reading memes	shawnaoh_
lol help text	shawnaoh_
amcdee outfit bad today	shawnaoh_
michael sos time phone fine	shawnaoh_
hollaclare tastes pepsi col	shawnaoh_
help vancouver police	shawnaoh_
free belly button ring piercing thing	shawnaoh_
vancouver acoustic sosassbutt sos live	shawnaoh_
rileyperri rly hot dp babe	shawnaoh_
literally sobbing bc forgot plug charger	shawnaoh_
will guys vancouver hey sos	shawnaoh_
amieisfierce ya too expensive	shawnaoh_
girls selfies starbucks straws mouths ya angry	shawnaoh_
sos calum sos ashton sos luke sos michael sos birthday follow guys	shawnaoh_
amieisfierce amie boo tonss	shawnaoh_
kimberlyyfaye favourite black person	shawnaoh_
tweets mother fianc thinks place baby floor hard	shawnaoh_
maciverjenna asked swaggot	shawnaoh_
calum sos jesus wheeeel	shawnaoh_
night rly satisfied	shawnaoh_
sos midnight bestest	shawnaoh_
talk loudly bus judging	shawnaoh_
minutes left doneeeeeeeeeeeeee chrisyourwords live	shawnaoh_
sarajangster considered rape happen	shawnaoh_
debating going science tutorials failing science	shawnaoh_
burning mixtapes normal people	shawnaoh_
literally suck dick	shawnaoh_
calum sos bby	shawnaoh_
hours movie lonely	shawnaoh_
kissing rain fucking perfect	shawnaoh_
swear follow pornhub twitter tumblr mom	shawnaoh_
aquarium god going	shawnaoh_
science ass shelter	shawnaoh_
vancouver sos live	shawnaoh_
ashton turn water sos live	shawnaoh_
chaseyourwords follow pretty pleeeeeease	shawnaoh_
hombosexuals shut mouth	shawnaoh_
jamesyourwords close omg happening	shawnaoh_
live vancouver wow will food chrisyourwords live	shawnaoh_
dis tru luv annaastren	shawnaoh_
christina perri happysad	shawnaoh_
masterchef intense rn	shawnaoh_
omfg school year	shawnaoh_
jessicashanno love god	shawnaoh_
haileymkrag wanna barbie girl	shawnaoh_
casual day selfies jennamaciver	shawnaoh_
luke sos god	shawnaoh_
wanna lock loveeee	shawnaoh_
jaeinjeong kristinnitara guys coming tomorrow	shawnaoh_
tbh grade girls clones eachother	shawnaoh_
drivers eding jennamaciver	shawnaoh_
ashton sos love yooou	shawnaoh_
amount respect miley cyrus	shawnaoh_
lohanthony tyleroakley laurenugh god love	shawnaoh_
tired hate life	shawnaoh_
ddlovato happy birthday gosh	shawnaoh_
hombosexuals itunes library rn	shawnaoh_
ashton sos feel better bby ily	shawnaoh_
days school omg sobbing	shawnaoh_
point dressing hipster slut concerts	shawnaoh_
calum sos caluuum	shawnaoh_
amandaayall hahahhahah boybands twitcams idek man	shawnaoh_
calum rugged calum sos sosanswerme	shawnaoh_
sosanswerme luke gangster sos live	shawnaoh_
offline omg going toshit sos live	shawnaoh_
yoooou sos live	shawnaoh_
hombosexuals idek man	shawnaoh_
screamed love people bus jumped cackling	shawnaoh_
michael sos michael	shawnaoh_
michael sos crying	shawnaoh_
harrysfedoraaax rock omg	shawnaoh_
calum sos love	shawnaoh_
lyke supposed lyfe	shawnaoh_
calum sos aw bby fun	shawnaoh_
hombosexuals wow dollars cents crunchy turtle wart	shawnaoh_
hombosexual ya mine	shawnaoh_
calum sos omg adorable wtf	shawnaoh_
jennamaciver going shoot	shawnaoh_
hombosexuals yesb ha aha	shawnaoh_
jennamaciver aw excited day slumber parti	shawnaoh_
ashton sos wow michael	shawnaoh_
calum sos guys cute	shawnaoh_
hollaclare omg today scared	shawnaoh_
peacelovehopey baconiam taylor swifts camel toe horrifying	shawnaoh_
calum sos hola hola	shawnaoh_
baconiam holy shit hell god	shawnaoh_
bachadam watch awkward omg love colin hell hate matty wanted jake mad	shawnaoh_
jennamaciver going cum vagina feel girlfriend	shawnaoh_
calum sos perfect ily	shawnaoh_
jaeinjeong kristinnitara pne sunday	shawnaoh_
calum sos volunteer tribute	shawnaoh_
jennamaciver rely heart pump blood	shawnaoh_
calum sos pretty sick hbu	shawnaoh_
ashton sos vegas	shawnaoh_
nightowl omg love you wow	shawnaoh_
mariahhauser kimberlyyfaye guys albino shhhhhh	shawnaoh_
mariahhauser hahahahahah watched george jungle omg hate	shawnaoh_
calum sos hear thousands miles	shawnaoh_
calum sos sass sass sass sass	shawnaoh_
calum sos waved going sum bye	shawnaoh_
post concert depression	shawnaoh_
favourite movie asklukey	shawnaoh_
amandaayall srs hur	shawnaoh_
masterchef night ya gordon	shawnaoh_
calum sos love meeeeeeeeee	shawnaoh_
calum sos love mee	shawnaoh_
move bc pee	shawnaoh_
laughing askfm hate ha	shawnaoh_
waking sounds awesome possum	shawnaoh_
montsedeveras saaaaambaaaaaaal saaaaaaambaaaal tbh reminds jamal	shawnaoh_
tumblr literally turned cory monteith tribute	shawnaoh_
talking hear satan calling omg	shawnaoh_
annaastren twerkling bitch	shawnaoh_
bitch better food	shawnaoh_
flower crowns mainstreamizrd stoppppppoppooopppppppepappepeppepeooo	shawnaoh_
dog rat swear	shawnaoh_
briannejoe high school sucks ehh	shawnaoh_
nice hot bedroomthx laptop fan	shawnaoh_
happy fathers day father	shawnaoh_
keviniskiho bad things	shawnaoh_
rachelmetznr friends considering krispy kreme	shawnaoh_
niallonnylon sucks suk	shawnaoh_
bachadam fabulous love	shawnaoh_
niallonnylon money buy sushi pizza	shawnaoh_
lakeerrah hahah omfg started giggling god	shawnaoh_
concept shaving leg hairs weird	shawnaoh_
bachadam omfg laughing hard adamisawhore	shawnaoh_
apples apples faggots yey	shawnaoh_
niallonnylon wait boyfriend wait wait	shawnaoh_
realliampayne love unhealthy	shawnaoh_
hey jacksgap finnharries challenged chicken nugget challenge tyleroakley	shawnaoh_
twerkling wait thomas parker	shawnaoh_
danielsahyounie will fried chicken follow	shawnaoh_
cali summer mom workout summer satan	shawnaoh_
jaeinjeong kmichaela ahaha bye jaein omg tara hahhhahahahahhaa	shawnaoh_
red coat wowowowowiq	shawnaoh_
rileyperri drunk idonthavesushi	shawnaoh_
joanneoh el el redddddd	shawnaoh_
reeseklein yeah howd	shawnaoh_
niallonnylon lool watched	shawnaoh_
pitch perfect losers jennamaciver doubledazzle	shawnaoh_
doubledazzle yeah chocolate drown sorrows	shawnaoh_
edsheeran fun shoot award god	shawnaoh_
sabrinamariaxo ohno thisisbad	shawnaoh_
starting pitbulls featuring	Simon_Pella
year ago today met meghantrainor toronto nice friendly thankyou	Simon_Pella
swear skin shedding going lizard	Simon_Pella
love money to concerts workhard relaxhard	Simon_Pella
slablasdos carter saturday spanish	Simon_Pella
likes taxis expensive drivers rude reckless will taxi topoli	Simon_Pella
people born amazing amazing	Simon_Pella
dejloaf beyonce video beautiful	Simon_Pella
force watch itim tempted	Simon_Pella
bangers pink print win feeling list yearofthepinkprint	Simon_Pella
grateful born raised canada peace	Simon_Pella
jessica jones good	Simon_Pella
voting nickiminaj amas artist year	Simon_Pella
justin bieber album amazing purpose	Simon_Pella
empire amazing tv acting sooooooooo good	Simon_Pella
watched fault stars amazing	Simon_Pella
ave mariashu shawna girl birth jesus	Simon_Pella
nickiminaj lost eyelashes lips tho nickionsnl	Simon_Pella
nehaaas loling hope hell	Simon_Pella
diditonembarbie nickiminaj clue	Simon_Pella
nickiminaj family trinidad trinidemgirls vid coming caught ya	Simon_Pella
lindsayglohan today tuesday	Simon_Pella
omfg vine albvn	Simon_Pella
skimmed mileys albumnot bad song sounds bad	Simon_Pella
hotlineting long haa	Simon_Pella
changed twitter finally swear	Simon_Pella
hello vc bhersch vine okitszake	Simon_Pella
weird seminar vine thepatrickwalsh	Simon_Pella
indie girl lyrically steps box vine mistachrish	Simon_Pella
hope better day fail vine failvine vinefail omg haha vine beinglatino	Simon_Pella
supposed happen hahahahahhahahahahahahhaha vine l x	Simon_Pella
savage shame pillsnpotions	Simon_Pella
jus sum advice vine abbydorning	Simon_Pella
attending ratchet funeral vine wtf von	Simon_Pella
people braces smileseemshuge goodlord vine kburton	Simon_Pella
nickiminaj yes yes	Simon_Pella
remember narnia credit explosm vine ilgsm	Simon_Pella
rich dad discipline vine jcyrusmusic	Simon_Pella
disappointasong widowed ladies single ladies	Simon_Pella
norm meekmill man kills	Simon_Pella
toronto nickiminaj surprises	Simon_Pella
hair hair funny comedy vine thececeshow	Simon_Pella
timothykennedy stephbarkley canaryy llow ageaintnothingbutanumber vine pagekennedy	Simon_Pella
dontjudgemechallenge fun watch	Simon_Pella
nickiminaj acceptance tho	Simon_Pella
remember grade grade facebook likes profile pictures competition young	Simon_Pella
chrishguerra vine wxvydre	Simon_Pella
concern noclass hopeheoktho teamcouz vine reggiecouz	Simon_Pella
babykmusic io parlo litaliano ma vostre canzoni anna wintour sparami sono fabulousi	Simon_Pella
nickiminaj rip insta vids	Simon_Pella
started bottom happybestfriendsday srxo	Simon_Pella
hahahaha vine holycrapitsrob	Simon_Pella
church girl church readyourbible vine ijaybe	Simon_Pella
hope fuck lol vine murgaro	Simon_Pella
nehaaas course text acc stuff watch	Simon_Pella
drake clownfish vine trevsoelectric	Simon_Pella
seduce bae vine jckianlawl	Simon_Pella
god vine jaredwonago	Simon_Pella
friends hit whip purpdrank anwarwj maxj vine piques	Simon_Pella
thick eyebrows unkept eyebrows	Simon_Pella
money turn noodles pasta	Simon_Pella
payed extra accident keepingit cashmoneyinthebuilding	Simon_Pella
pep talks party edition vine andrearussett	Simon_Pella
booty shedo thr bak vine allicattt	Simon_Pella
grade instagram bio drewistru vine nut	Simon_Pella
jevonieg srxo fuck	Simon_Pella
day school promise	Simon_Pella
met meghantrainor currently unable breath supppper nice	Simon_Pella
nickiminajs laugh kills everytime hear	Simon_Pella
nickiminaj chi raq shivers	Simon_Pella
big grade boy	Simon_Pella
nickiminaj making boo	Simon_Pella
nickiminaj time retireyaphone logoutyaphone	Simon_Pella
nickiminaj shanghai shangbye	Simon_Pella
srxo lol coming girl stays tired bus tweets	Simon_Pella
shanghai grand piano feeling night young hard nickiminaj thepinkprint	Simon_Pella
queenclassy hey secret santa tomorrow	Simon_Pella
nickiminaj album fleek pretty thepinkprintonitunes	Simon_Pella
nickiminaj background thepinkprinkonitunes	Simon_Pella
understand destroying police cars setting local business fire fergusondecision ripmikebrown	Simon_Pella
girl pretends love asked sing mariah carey vine	Simon_Pella
conversation listening bus stupid hurts	Simon_Pella
analysis times coincidence	Simon_Pella
muscle shirts muscles tammy	Simon_Pella
shmoney dance inappropriate times idea shmoney dance vineapp	Simon_Pella
cry video outt	Simon_Pella
simonasantagato songs album lol	Simon_Pella
mom yell vineapp	Simon_Pella
love coughing time abs	Simon_Pella
drakes dog lolol nickiminaj	Simon_Pella
going spend day yay friends popular	Simon_Pella
toronto adventure lilysumms	Simon_Pella
nickiminaj august married noloveremix	Simon_Pella
going school tomorrow nothanks	Simon_Pella
ready ontherutour cantwait simonasantagato	Simon_Pella
farm life life	Simon_Pella
molson amphitheatre worst reception ggoestodie	Simon_Pella
srxo whoops calm	Simon_Pella
weston cup jakeh drigoamigo	Simon_Pella
fight taller ppl rudy mancuso remix brittney dorey splack bigdaddykane wuz good ranked	Simon_Pella
nickiminaj canada pillsnpotions	Simon_Pella
pillsnpotions wait nickiminaj	Simon_Pella
bollywood dance workshop	Simon_Pella
simonasantagato ready born ready	Simon_Pella
selfie nonna drives	Simon_Pella
kerrywashington scandalfinale course sally capitalizing	Simon_Pella
lindsay hall funny	Simon_Pella
record breaking weekworst march break worst week useless week evermost lonely week evercries eats chips	Simon_Pella
simmer fine hockeyproblems	Simon_Pella
ahscoven sugar real	Simon_Pella
grade place ffs	Simon_Pella
lol guys alumnigame	Simon_Pella
ended guillermo del toro film set today walking	Simon_Pella
wasteman driving school	Simon_Pella
hate stupid driving course	Simon_Pella
nicki minaj youtube music awards artist year youtube	Simon_Pella
whites bathroom aint help bitch will eat shit	Simon_Pella
wreckingball love video	Simon_Pella
rogershelps stupid youtube commercial shirt running ewant kill	Simon_Pella
jessica lang amazing actress fathom	Simon_Pella
gettin braces today	Simon_Pella
pledge allegiance murica	Simon_Pella
eyes hurt life	Simon_Pella
honked whistled today life complete	Simon_Pella
days till birthday	Simon_Pella
shushawnaa alive twitter hour everyday day	Simon_Pella
love chris brown ft nicki minaj	Simon_Pella
spotted room nickiminaj	Simon_Pella
feel staff dorm hearing	Simon_Pella
man steel amazing movie quality story quailty character development quality graphics	Simon_Pella
small popcorn lifeisgood	Simon_Pella
nickiminaj will collabs beyonce futcha	Simon_Pella
tremelvin watched videos subscribed yesterday halarious	Simon_Pella
science notes counting	Simon_Pella
rob ford jimmy kimmel	Simon_Pella
shushawnaa you priorities straight	Simon_Pella
letting sleep couch night hobo	Simon_Pella
eyes feel vaginas saggy long	Simon_Pella
massive nosebleeds morning life	Simon_Pella
bored hell invite desperate	Simon_Pella
early morning nosebleeds start day	Simon_Pella
soo acne medications creams uh	Simon_Pella
nickiminaj love legit faces faces times	Simon_Pella
gleeonfox ready entertained	Simon_Pella
simonasantagato crew pretending care marlies hockeyfans	Simon_Pella
nickiminaj plays clarinet piano bet	Simon_Pella
demonic chants youtube film literally scared	Simon_Pella
lurk atleast people facebook day goodreally boring day	Simon_Pella
hey sweet pea chicken ball fried dumpling japanese banana pancake thought obsessed nickiminaj amazing simply amazing	Simon_Pella
problem elvis horse	Simon_Pella
double cheese burger fries side mcdonalds	Simon_Pella
thingsyouhatetodo involve eating	Simon_Pella
movies movies movies	Simon_Pella
grudge funniest movie lol	Simon_Pella
lazy print project procrastination	Simon_Pella
nehasati best thing wait face	Simon_Pella
burger afternoon tasted water	Simon_Pella
happy valentines day offtoengland	Simon_Pella
tierra thinks sparkle cute	Simon_Pella
shit naut drav	Simon_Pella
fucking tierra son bitch snake snakes mad	Simon_Pella
damn amazing beyoncebowl	Simon_Pella
shushawnaa skype pls	Simon_Pella
maddylandry bus foot left	Simon_Pella
girleatstampon disgusting thing	Simon_Pella
nickiminaj hilarious idol	Simon_Pella
heard kid bus wasted stupid ironic	Simon_Pella
lana ray born die	Simon_Pella
nickiminaj hiatus ereboody sooooooooooo happy birthday merry christmas happy year	Simon_Pella
beyonce nicki minaj playlist newyear	Simon_Pella
stfu daniel goddamn	Simon_Pella
going sushi ailishpella madre	Simon_Pella
thepussyasylum will forgot	Simon_Pella
rap rhyming lines pro	Simon_Pella
hey nickiminaj good morning	Simon_Pella
shushawnaa profile picture	Simon_Pella
deserved math test swag	Simon_Pella
thereup feel buy nickiminaj	Simon_Pella
kicked danntron chiar	Simon_Pella
post blog check jamies leslievillestreetstyle fashion torontostyle styleblogger	styleofthesix
limecrime canadian retailer carries products canadian website	styleofthesix
forgive forget lc aka life mantra	tanya_babbar
